автоматический: автоматических автоматического
анатомия: Анатомия
анонимный: анонимные
аргумент: аргументов аргумента
базовый: базового
безбоязненный: Безбоязненный
библиотека: библиотеки
билд: билдов
бинарный: бинарных
более: Более
большинство: Большинство
будущее: будущем
быть: будем быть были была есть
важный: важно важных
валидация: Валидация
ваш: вашего вашу вашем вашей ваш ваша
введение: Введение
ввести: введите введём введя
ввод: вводом
веб: веб
вектор: векторами
вернуться: вернитесь
весь: Все всего всех всю всё всеми
видеть: видите
видимость: видимости
включить: включила
владение: владения владение
вместо: вместо
внутренний: внутренняя
возвращать: возвращает
возможность: возможности возможностей возможность
возможный: возможно
впервые: впервые
время: время
всегда: всегда
второй: вторых
вы: вы вас вам
вывести: выведена выведет
вывод: выводом вывода
выводимые: Выводимые
выводить: выводит
выводиться: выводится
вызвать: вызвана
вызов: вызов
вызываться: вызывается
выполнение: выполнением Выполнение выполнения
выпуск: выпуска
выражение: выражения
где: где
глава: главе
головоломка: головоломки
давать: Давайте даёте
далее: Далее
данные: Данных данные
данный: данной
два: два
двоичный: двоичный
действие: действия
делать: делает
дело: деле
дерево: дереве
деталь: деталях детали
дизайн: дизайне
динамический: динамическими
директория: директории директорию
дистрибутив: дистрибутив
для: Для
добавить: добавив
добавление: добавления
добро: добро
документация: документации
должный: должна должен должны
домашний: домашнем
допускать: допускающих
достаточный: достаточно
другой: других другому
жизнь: жизни
завершать: завершаем
завершение: завершение
загадка: загадки
заимствование: заимствование
заканчиваться: заканчиваются
заключаться: заключались
заключить: заключено
закодировать: закодированного
заметить: заметить заметите
замыкание: замыкания
запись: Запись
запуск: запуск запуска запуском
запускать: запускаете запускать
запускаться: запускается
запустить: запустили запустить
запятая: запятой
затем: Затем
захватывать: захватывают
захотеть: захотите
знакомый: знакомы
знать: знать
значение: значений значениями значения
игра: игры
изменяемость: изменяемость
изучение: изучении
иметь: имеет
имя: имени именем имя
иной: иной
инструмент: инструменты инструмент инструментом
инструментарий: инструментарием
интегрировать: интегрированную
информация: информацию
исполняемый: исполняемой исполняемый
использование: Использование использовании
использовать: использующей использовать используйте используете Используя
использоваться: использоваться
исходный: исходный исходного
итератор: итераторы итераторов
каждый: каждой каждый
какой: каким
каталог: каталоге каталог
качество: качестве
ключ: ключей
ключевой: ключевого Ключевые
книга: книги книга книге
код: кода код
коллекция: коллекции
команда: команд Команда команды команду
командный: командной
комментарий: Комментарии
компилировать: компилировать
компилятор: компилятора
компиляция: компиляции Компиляция
компромисс: компромисс
компьютер: компьютере
конструкция: конструкции Конструкция
конфиденциальность: конфиденциальностью
концепция: концепции
который: которые которая которой который
крейт: крейтов крейты крейта
круглый: круглые
кто: кому
куча: куче
лаконичный: Лаконичный
листинг: Листинг
любимый: любимую
макрос: Макросы макрос макроса макросу
маленький: маленькой
мера: мере
место: места
метод: метода
мир: Мир мира
многий: Многие
многопоточный: многопоточного многопоточный
модуль: модулей
модульность: модульности
можно: можно
мочь: могут может можете
мы: мы
мягкий: Мягкое
набрать: набрана
навык: навыка
название: Название названием
назвать: назовите
наличие: наличие
напечататься: напечаталось
написание: Написание
написать: написать написали
например: Например
настройка: Настройка
начало: начала
начать: начать начнём
наш: нашего наш наши
небезопасный: Небезопасный
небольшой: небольшую
нее: неё
независимый: Независимо
неполадка: неполадок
неустранимый: Неустранимые
ничто: ничего
новый: нового новый
нужный: нужна
обеспечение: обеспечения обеспечении
область: областью область области
обобщенные: Обобщённые
оболочка: оболочке
обработка: Обработка обработки
образец: образцом
обратитесь: обратитесь
обсудить: обсудим
обсуждать: обсуждаемых
общий: Общие общим
объединение: объединения
объект: объектов
объектный: объектно
объявление: объявление
объявлять: объявляет
обычный: обычными обычной
один: одного один одна
однако: Однако
однопоточный: однопоточного
окно: окно
окончание: окончание
окружение: окружение
он: его он него
она: она её ей
они: их они ними
оператор: Операторы
операционный: операционной
определение: Определение
определенный: определённом
определять: определяют
опровержимость: Опровержимость
опыт: опыт
организация: Организация
ориентировать: ориентированного ориентированных
особенный: особенная
особый: особых
отдельный: отдельные
откройте: Откройте
открывающую: открывающую
открыть: откроем
отладочный: отладочную
отличный: отличной
отступ: отступ
отсюда: Отсюда
очистка: очистке очистка
ошибка: ошибок ошибки ошибках
пакет: пакетов Пакеты
память: памяти
папка: папки
параллелизм: параллелизм
параллельный: параллельного
параметр: параметров параметры параметрами
первый: первую первой первая первый первых
перевод: Переводы
передавать: передаём
передать: передав передать
передача: передачи передачу
переменный: Переменные переменными
пересылка: Пересылка
перечисление: Перечисления
печатать: печатает
писать: писать
платформа: платформах
поведение: поведения
поддерживать: поддерживают
поддержка: поддержки
подразумевать: подразумевает
подробнее: Подробнее
подробно: подробно
подробность: подробности
подробный: подробную
подсчет: подсчётом
подходить: подходит
подчеркивание: подчёркивания
подчиняться: подчиняются
пожаловать: пожаловать
поздравление: поздравления
познакомить: познакомим
пока: Пока
показывать: показывает
полезный: Полезные
получение: Получение
получить: получить
пользовательский: пользовательских
пользоваться: пользуетесь
поместить: поместить
помочь: поможет
помощь: помощью помощь
понимание: Понимание
последовательность: последовательности
поток: потока поток потоков потоками
похожий: похоже
поэтому: поэтому
правило: правилам
превращение: Превращение
предварительно: предварительно
предисловие: Предисловие
предполагать: предполагает
предпочитать: предпочитаете
предъявлять: предъявляет
прежде: Прежде
привести: привести
привет: Привет
привыкнуть: привыкли
придерживаться: придерживаться
прийти: пришло
приложение: Приложения Приложении
пример: Пример
примечание: Примечание
принятый: принято
принять: примите
пробел: пробел пробела
программа: программы программу программ Программа программе
программирование: программирования Программирование
программист: программистом
продвинуть: Продвинутые
проект: проектами Проект проекта проектов проектах
проектирование: проектирования
производительность: производительности
простой: простых
профиль: профилей
процесс: процесса
публикация: Публикация
путь: Пути путей
работа: Работа работы работу
рабочий: Рабочие
раздел: разделу
разделять: разделяемого разделять
разный: разных
разработка: Разработка разработки
рассмотреть: рассмотрим
расти: растущими
расширение: Расширение расширением
расширить: Расширенные
расширять: Расширяемый
реализация: Реализация
реальный: реального
редактирование: редактирования
редакция: Редакции
рефакторинг: Рефакторинг
рост: роста
сам: самом
самый: самое
свой: своё свою
связать: связанных связанными
сделать: сделаем
сейчас: сейчас
сервер: сервера сервер
символ: символы символом
синтаксис: Синтаксис
система: системы
скобка: скобок скобку
скобки: скобки
скомпилировать: скомпилировать скомпилированный
следующий: следующие следующий следующего следующее
слово: слова
сметь: смело
смотрите: смотрите
смочь: сможет
советовать: советуем
содержать: содержит содержащий
создаваться: создаётся
создание: создание создания
создать: создать создайте созданную
сообщение: сообщений
соответственно: соответственно
соответствовать: соответствовать
сопоставление: сопоставление
сосредоточиться: сосредоточилась
состояние: состоянием
сохраните: Сохраните
сохранять: сохранять
список: списков
сравнение: Сравнение
среда: среды среду
срез: среза
срок: сроков
ссылка: Ссылки ссылок ссылками
ссылочные: Ссылочные
стандартный: стандартного стандартный
степень: степени
стиль: стиль стиля стиле
строка: строками строки строкой строка строку строк
структура: структур структуры
табуляция: табуляцию
такой: такое такого такие такими
там: там
текст: текста текст
тело: Тело тел
теперь: Теперь
терминал: терминал терминала
тест: тестов тесты
тестирование: тестирование
тип: Типы Тип типов
типаж: типажи
тот: то тому той того ту тем
точка: точкой
традиционный: Традиционно
требование: требований
требовать: требует
трейт: трейта трейтов трейт
трейты: трейты
третий: третьих
три: три
увидеть: увидеть увидите
уже: уже
узнать: узнать
указание: указания
указатель: указатели указателями указатель
указывать: указывает
улучшение: улучшения Улучшение
умный: Умные умными умный
управление: управления Управление
управлять: Управляющие управлять
упражнение: упражнений
упростить: упростить
успешный: успешной
установить: установили установлен установленного установлена
установка: Установка
устранение: Устранение
устранимые: Устранимые
утечка: утечке
файл: файла файлов файл Файлы
фигурный: фигурных фигурную
финальный: Финальный
форматирование: форматирования
функциональность: функциональности
функциональный: Функциональные
функция: Функции функцию Функция функций
характеристика: характеристики
хороший: Хороший лучше
хотеть: хотите
хранение: Хранение хранения
хранить: хранить
цикл: циклы
часть: часть
четвертый: четвёртых
четыре: четыре
чтение: Чтение
что: чего Что
шаблон: шаблона Шаблоны шаблон
шаг: шаги шаг
экземпляр: экземпляров
экран: экране экран
элемент: элемент элементов
это: это этого
этот: Эта Эти этот этой этих
язык: Язык языка языков языке языками языках
