автоматически: автоматически
автоматический: автоматических автоматического автоматическую
аналогичный: аналогичен
анонимный: анонимные
аргумент: аргументов аргумента
безбоязненный: Безбоязненный
безопасный: безопасной
беспокоиться: беспокоиться
библиотека: библиотеки библиотекой библиотеке
билд: билдов
бинарный: бинарных
блокировка: блокировки блокировками блокировку
большой: больше
быть: будет была будете
важный: важным
валидация: Валидация
ваш: вашего ваш
введение: Введение
ввод: вводом
вводить: вводить
веб: веб
везде: везде
вектор: векторами
весь: Все вся весь
видимость: видимости
включить: включён
владение: владения владение
вместо: вместо
внимание: внимание
внутренний: внутренняя
возможность: возможности возможностей
возникать: возникающих
время: время времени
вручную: вручную
всегда: всегда
вставлять: вставлять
всякий: всякий
второй: Вторым
вы: Вы вам вас
вывести: выведет
вывод: выводом вывод
выводимые: Выводимые
вызвать: вызовет вызвать вызвало
вызов: вызов вызова
вызывать: вызывать вызывает вызывал вызываем
вызываться: вызывается
выйти: выйдет выйдут
выполнение: Выполнение выполнением выполнения
выполнить: выполнив выполнить
выполнять: выполняет выполнять
выполняться: выполняться
выпуск: выпуска
высвобождение: высвобождения
выход: выхода
выходить: выходит
гарантировать: гарантирует
где: где
говорить: говорит
давать: давайте
данные: Данных данные
данный: данного
дать: дать
два: два
дважды: дважды
деаллокация: деаллокация
действие: действия
действительный: действительны
делать: делает
дерево: дереве
дескриптор: дескрипторы
деструктор: деструктор деструктором
добавить: добавили
добавление: добавления
должный: должен должна должны
допускать: допускающих
досрочный: досрочной
другой: другой другими
единственный: единственной
еще: ещё
жизнь: жизни
заботиться: заботиться
забыть: забыть
завершать: завершает
завершаться: завершается
завершение: завершение
загадка: загадки
задавать: задавать
задать: задать заданный
заимствование: заимствование
закодировать: закодированного
замыкание: замыкания
запись: Запись
запуск: Запуск
запустить: запустим
затем: затем
захватывать: захватывают
захотеть: захотите захотеть
здесь: здесь
значение: значений значениями значения значение
игра: игры
избавиться: избавиться
изменить: изменить
изменяемость: изменяемость
изменяемый: изменяемую
изменять: изменяя
иногда: Иногда
инструкция: инструкций
инструмент: инструменты
использование: Использование
использовать: использующей использовать
использоваться: использоваться используется используются
итератор: итераторы итераторов
каждый: каждый
качество: качестве
ключ: ключей
ключевой: ключевого Ключевые
книга: книги
когда: когда
код: кода код
коллекция: коллекции
команда: команд
командный: командной
комментарий: Комментарии
компилятор: компилятор компилятора
конец: конце конца
конструктор: конструктору
конструкция: конструкции Конструкция
контекст: контексте
конфиденциальность: конфиденциальностью
концепция: концепции
который: которые который которое которая которой которую
крейт: крейтов крейты крейта
куда: куда
куча: куче
лаконичный: Лаконичный
листинг: листинге Листинг листинга
логика: логику логика
любой: любого
макрос: Макросы
менеджер: менеджера
место: места место
метод: метода метод
мир: Мир
многопоточный: многопоточного многопоточный
модуль: модулей
модульность: модульности
момент: момент
мочь: могут может можете могли мог можем
мы: Мы нам нами
мягкий: Мягкое
наглядно: наглядно
наглядный: наглядное
напечатать: напечатает напечатанный
написание: Написание
например: Например
напрямую: напрямую
настройка: Настройка
находиться: находится
начать: начать
наш: нашего наш наши наше наших
небезопасный: Небезопасный
невозможный: Невозможно
некоторый: некоторых
нельзя: нельзя
неустранимый: Неустранимые
нужный: нужно
обеспечение: обеспечения
область: областью область области
обобщенные: Обобщённые
обработка: Обработка обработки
образец: образцом
обратите: Обратите
обратный: обратном
обращаться: обращаться
общий: Общие общим
объединение: объединения
объект: объектов
объектный: объектно
обычно: обычно
обычный: обычными
один: одного Одним одно один
однако: однако
однопоточный: однопоточного
оказаться: окажется
окончательный: окончательное
окружение: окружение
он: он его
она: её
они: их
оно: оно
оператор: Операторы
определение: Определение
определенный: определённый определённого определённую определённым определёнными
опровержимость: Опровержимость
организация: Организация
ориентировать: ориентированного ориентированных
освобождать: освобождать
освобождение: освобождения
отключение: отключение
отключить: отключить
отличаться: отличается
очистить: очистить
очистка: очистке очистка очистки очистку
очищать: очищает
ошибка: ошибок ошибки ошибках ошибку ошибке
пакет: пакетов Пакеты
память: памяти
параллелизм: параллелизм
параллельный: параллельного
перевод: Переводы
перегрузить: перегруженной
передавать: передавая
передача: передачи
переменный: Переменные переменными
пересылка: Пересылка
перечисление: Перечисления
печатать: печатаем печатать
печать: печать
писать: писать
поведение: поведения
подробнее: Подробнее
подстановка: подстановку
подсчет: подсчётом
позаботиться: позаботились
позволять: позволяет
познакомиться: познакомились познакомимся
показать: показана показать показано
показывать: показывает
полезный: Полезные
получение: Получение
получить: получить получим
пользовательский: пользовательских
поместить: поместим
помощь: помощью
понимание: Понимание
попытаться: попытаться попытаемся попытался
попытка: Попытка
порядок: порядке
последовательность: последовательности
поток: потока поток потоков потоками
потому: потому
потребовать: потребовать
поэтому: поэтому
практически: практически
превращение: Превращение
предел: пределы
предисловие: Предисловие
предоставлять: предоставляемую
представление: представление
прелюдия: прелюдию прелюдии
привести: привести
привет: Привет
признак: признак
приложение: Приложения
пример: Пример Примерами примера примеров
принимать: принимает
принудительно: принудительно
принудительный: принудительный принудительного
проблема: проблемах
программа: программы программе программу
программирование: программирования Программирование
программист: программист
продвинуть: Продвинутые
продемонстрировать: продемонстрировать
проект: проектами Проект проекта
проектирование: проектирования
производительность: производительности
происходить: происходит
простой: простым
пространство: пространства
профиль: профилей
публикация: Публикация
путь: Пути путей
работа: Работа работы
работать: работает
рабочий: Рабочие
равный: равно
раз: раз
разделять: разделяемого
размещение: размещении
разный: разных
разработка: Разработка разработки
ранний: Раннее раньше
рано: рано
располагаться: располагаться
рассматривать: рассматриваем
расти: растущими
расширение: Расширение
расширить: Расширенные
расширять: Расширяемый
реализация: Реализация реализации
реализовать: реализовать реализовав реализуем реализующая
регулировать: регулировать
редакция: Редакции
результат: результат результате
ресурс: ресурсов ресурсы
рефакторинг: Рефакторинг
самый: самым
сброс: сбросе
свой: своё своего
свойство: свойства
связать: связанных связанными
сделать: сделать
сервер: сервера сервер
сетевой: сетевые
символ: символы
синтаксис: Синтаксис
система: система системы
скомпилировать: скомпилировать
следовать: следует
следствие: следствие
следующий: следующий
слово: слова
служить: служить
случай: случаях случае
случайный: случайной
смысл: смысл
снимать: снимает
собственный: собственного
соединение: соединения
сожаление: сожалению
создавать: создаём создаёт
создаваться: создаётся
создание: создание создания
сокет: сокеты
сообщение: сообщений сообщение сообщении
соответствовать: соответствовать
сопоставление: сопоставление
состояние: состоянием
специально: специально
список: списков
сравнение: Сравнение
среда: среды
срез: среза
срок: сроков
ссылка: Ссылки ссылок ссылками ссылку
ссылочные: Ссылочные
стандартный: стандартной
строка: строками строки
структура: структур структуры структура
так: так
также: также
такой: такое таких
текст: текста текст текстом
тело: Тело
термин: термин термином
тест: тестов тесты
тестирование: тестирование
тип: Типы Тип типов типа
типаж: типажи типажа типажом типаж
типичный: типичных
тот: тем том той то того
точка: точке
требовать: требует
требоваться: требуется
трейт: трейта трейтов трейт
трейты: трейты
увидеть: увидеть увидим
удаление: удаление удаления
удалить: удалена удалить
удаляться: удаляются
удобный: удобной
указание: указания
указанный: указанный
указатель: указатели указателями указатель указателя указателей
указать: указать
указывать: указывает
улучшение: улучшения Улучшение
умный: Умные умными умный умного умных
уникальный: уникальной
уничтожить: уничтожить
упасть: упасть
управление: управления Управление
управлять: Управляющие управляют
установка: Установка
устранимые: Устранимые
утечка: утечке утечки
файл: файла файлов файлы Файл
финальный: Финальный
фрагмент: фрагмент
функциональность: функциональности функциональность функциональностью
функциональный: Функциональные
функция: Функции функцию Функция
характеристика: характеристики характеристиками
хотеть: хотите хотим
хранение: Хранение
цель: Цель
цикл: циклы
чтение: Чтение
что: чего Что
чтобы: Чтобы
шаблон: шаблона Шаблоны шаблон
экземпляр: экземпляров экземпляра экземпляр экземпляры
элемент: элемент элементов
это: этом это
этот: этот этих эту этого этой
являться: является
явно: явно
язык: Язык языка языков языках
