автоматический: автоматических
анализ: анализ
анализатор: анализатора
аннотация: Аннотация аннотации
аннотировать: аннотировать аннотировали аннотированного аннотировал аннотирует
анонимный: анонимные
аргумент: аргументов аргументом аргументами
ассоциированный: ассоциированную
атрибут: атрибута атрибутам атрибуты атрибут атрибутов
атрибутный: атрибутного атрибутные
безбоязненный: Безбоязненный
библиотека: библиотеки библиотеке
библиотечный: библиотечный
билд: билдов
бинарный: бинарных бинарный
блок: блок
более: более
больше: больше
больший: большего
большинство: большинстве большинство
будущее: будущем
буквально: буквально
буквенный: буквенный
быть: быть будет будут был было была будете
важный: важное
валидация: Валидация
ваш: ваш вашего ваших
введение: Введение введения
ввести: ввести введённый
ввод: вводом
веб: веб
вектор: векторами вектора вектор
вернуть: вернуть
версия: версия версии
весь: Все всей весь всем всех
ветвь: ветвь ветви ветвью
ветка: ветки
вид: вида видов виды виде
видеть: видите
видимость: видимости
вирт: Виртом
включить: включённым включена
владение: владения владение
вместе: вместе
вместо: вместо
внешний: внешней
внимание: внимание
внутренний: внутренняя внутренней
внутри: Внутри
во: Во
возвращать: возвращает Возвращаемый возвращать возвращаем
возможность: возможности возможностей возможность
возможный: возможным возможно
вообще: вообще
восклицательный: восклицательного
время: время временем
вручную: вручную
вскоре: Вскоре
встроить: встроен
вступать: вступает
всякий: всякий
второй: Вторая Второй
входной: входных входным
вы: вас вами вы вам
вывести: выведет вывести
вывод: выводом вывода
выводимые: Выводимые
выводить: выводимого выводимым выводимых
выглядеть: выглядят выглядеть
выдать: выдаст
выделение: выделения выделение
вызвать: вызвать
вызов: вызовы вызов вызова вызову
вызывать: вызывать вызываем
вызываться: вызывается вызываться
выполнение: выполнением Выполнение выполнения
выполните: выполните
выполнить: выполнить выполним
выполнять: выполняют выполнять
выпуск: выпуска
выражение: выражение выражения выражению выражениям выражением
выходной: выходным
вычислять: вычисляют
где: где
генерация: генерации
генерировать: генерирует генерировать генерировал
генерироваться: генерируется
гибкий: гибкими
глава: главе главу
глядя: глядя
гораздо: гораздо
давать: давайте даёт
далее: Далее
данные: Данных данные
данный: данный данном
два: двумя двух два
действие: действия действии
действительный: действительный
действовать: действуют
декларативный: декларативные
делать: делают делающие делать делает делаем
дерево: дереве дерева
добавить: добавленный добавить добавлен добавим добавил
добавление: добавления
добавлять: добавлять
добавляться: добавляется
добавьте: Добавьте
документация: документации документацию
должный: должны должна должен
доллар: доллара
дополнительно: дополнительно
дополнительный: дополнительные дополнительной дополнительный дополнительную
допускать: допускающих
допустимый: Допустимый
допустить: допустим
достижение: достижения
доступный: доступен доступны
другой: другой Другое другим другие Другими другому других
дэниел: Дэниелом
его: его
единственный: единственным
есть: есть
еще: ещё
желаемый: желаемой
жизнь: жизни
завершение: завершение
завершиться: завершиться
зависимость: зависимости зависимость зависимостей зависимостями
загадка: загадки
задать: заданного задать
задача: задачей
заимствование: заимствование
заключаться: заключается
закодировать: закодированного
закончить: закончим
замена: замены замену
заменить: заменит
заменять: заменяет заменяющий
заменяться: заменяется
заметить: заметили
замыкание: замыкания
записывать: записывает
запись: Запись
заполнитель: заполнителем
запускать: запускают запускаем
запятая: Запятая
заранее: заранее
затем: затем
захватывать: захватывают
зачем: зачем
звездочка: Звёздочка
здесь: здесь
знак: знака знак
знать: знали знать
значение: значений значениями значения значение значением
игра: игры игру
идентификатор: идентификатором идентификатор
иза: Из
избавить: избавить
известный: известно
изменить: изменим изменить изменённом
изменяемость: изменяемость
изучить: изучили
именовать: именованный
иметь: имеют иметь имеет имеющий
иметься: имеющихся
имя: имени имя именем
иногда: иногда
инструкция: инструкцию
инструмент: инструменты
интерпретировать: интерпретирует интерпретировать
информация: информации
использование: Использование использования использовании использованием
использовать: использующей использовали используемые используемой использовать используем использующие использует используя используемый
использоваться: использоваться используется
используйте: Используйте
исправить: исправить
исходный: исходный исходного
итератор: итераторы итераторов
итог: Итоги
каждый: каждом каждым каждой каждое каждого
какой: какие какой
каталог: каталоге
качество: качестве
кип: Кипом
классный: классную
ключ: ключей
ключевой: ключевого Ключевые
книга: книги книга
когда: Когда
код: кода код кодом коде коду
количество: количества количество
коллекция: коллекции
команда: команд команда команды
командный: командной
комментарий: Комментарии
компилятор: компилятор компилятора
компиляция: компиляции
конкретный: конкретным конкретные
конструкция: конструкции Конструкция
конфиденциальность: конфиденциальностью
концепция: концепции
косвенность: косвенности
который: которые который которых которую которого которая котором которое которым которой которому
крейт: крейтов крейты крейта крейт крейте крейтом
куча: куче
лаконичный: Лаконичный
листинг: листинге Листинг листинга
литерал: литералом литерал
лукас: Лукасом
любой: любого любой любому любое
макро: макро
макропеременная: макропеременная
макрос: Макросы макрос макросов макросами макроса макросу макросом макросе макросам
маленький: Маленькая
манипулировать: манипулировать манипулирует
мгновение: мгновение
менее: менее
место: места
мета: мета
метод: метода
механика: механику
мир: Мир
многопоточный: многопоточного многопоточный
модуль: модулей
модульность: модульности
можно: можно
момент: момент
мочь: могут может можем можете могли мог
мы: Мы нас Нам
мягкий: Мягкое
набор: набор
надеяться: надеемся
название: Название
называться: называется
наиболее: Наиболее
найти: найти
напечатать: напечатает напечатать
написание: Написание написания
написать: написанный написать напишем
например: например
настраивать: настраиваемые
настройка: Настройка
находиться: находится находиться находятся
начать: начать начатая Начнём
начинать: начинаем
наш: нашего Наши нашей Наш
небезопасный: Небезопасный
небольшой: небольшие
неизвестный: неизвестное
некоторый: некоторые некоторое некоторый
нельзя: нельзя
необходимость: необходимости
несколько: несколько
неудача: неудачу
неустранимый: Неустранимые
нечто: нечто
новый: нового новый новых новые
ноль: ноль
нужный: нужны нужен нужно
оба: обоих
обеспечение: обеспечения
область: областью область области
обобщенные: Обобщённые
обрабатывать: обрабатывать
обработка: Обработка обработки обработкой
образ: образом
образец: образцом
обратите: Обратите
обратиться: обратитесь
обратно: обратно
обратный: Обратной
обстоятельство: обстоятельствах
обсуждать: обсуждаем обсуждали
обсуждаться: обсуждалось
общий: Общие общим общего
объединение: объединения
объект: объектов
объектный: объектно
объем: объёма
объявить: объявить объявлен объявленным
объявление: объявления объявление
объявлять: объявлять
объявляться: объявляется
объяснить: объясним
обычный: обычными обычная обычные
ограничение: ограничение
один: одним одна один одной одном одну
одинаковый: одинаковым
однако: Однако
однопоточный: однопоточного
ожидать: ожидает
означать: означают означающим
оказаться: оказаться
окружение: окружение
он: он ним ему него
она: она
они: них их Они им
онлайн: онлайн
оператор: Операторы
операция: операции
описание: описания
определение: Определение определения определениях
определенный: определёнными
определить: определили определён определим определить
определять: определяют определяет определяющий
опровержимость: Опровержимость
оптимизация: оптимизацией
опубликовать: опубликовать
организация: Организация
ориентировать: ориентированного ориентированных
особый: особых
остальной: остальная
отвечать: отвечает
отдельно: отдельно
отличаться: отличается отличающимися отличаться отличаются
отличие: отличии
отличный: отличное
отменить: отменено
относиться: относится
охватить: охватить
очень: очень
очередь: очереди
очистка: очистке очистка
ошибка: ошибок ошибки ошибках ошибке ошибку
пакет: пакетов Пакеты
память: памяти
паника: панику
паниковать: паниковать
параллелизм: параллелизм
параллельный: параллельного
параметр: параметров параметра параметр
первый: первых Первый
перевод: Переводы
передать: переданным переданный
передача: передачи
переменный: Переменные переменными переменное переменной переменная
пересылка: Пересылка
перечисление: Перечисления перечислений
печатать: печатать
печать: печати
писать: писать
платформа: платформой
поведение: поведения
повторение: повторение
поговорить: поговорим
поддерживать: поддерживать
подключить: подключим
подобный: подобные подобное подобного
подробнее: Подробнее
подробный: подробного
подсчет: подсчётом
позволить: позволит
позволять: позволяют позволяет
поиск: поиск
пойти: пошло
пока: пока
показать: показано показанный
показывать: показывает показывают
поле: Поля полей поле
полезный: Полезные полезно
полностью: полностью
полный: полный полного
получать: получаем получаемый
получение: Получение получения
получить: получили получат получить
пользователь: пользователи пользователь пользователями
пользовательский: пользовательских Пользовательские пользовательского пользовательский
поместить: поместите
помочь: поможет
помощь: помощью
понадобиться: понадобятся
понимание: Понимание
понимать: понимать
последовательность: последовательности последовательность
посмотреть: посмотрим
поставляться: поставляется
построить: построим
потерпеть: потерпит
поток: потока поток потоков потоками
потому: потому
потребоваться: потребуется
похожий: Похожие похожее похожа похожи похоже
почти: почти
поэтому: поэтому
появиться: появиться
появление: появлении
правило: правило
правильный: правильного правильно правильная
практика: практике
превращать: превращает превращают
превращение: Превращение
предварительный: предварительного
предисловие: Предисловие
предложение: предложением
предназначение: предназначений
предоставить: предоставим предоставить
предоставлять: предоставляем предоставляет
представить: представили
представление: представление
представлять: представляет представляющую
предшествовать: предшествует
прежде: прежде
преобразование: преобразование преобразования
преобразовать: преобразует преобразовать
привести: привести приведено приведёт
привет: Привет
прийтись: придётся
прикрепить: прикреплённый прикреплён
приложение: Приложения Приложении приложений
применить: применим
применяться: применяться
пример: Пример примере Примером
примечание: Примечание
принимать: принимать принимают принимает
причина: причин
проанализировать: проанализированного
проверить: проверьте
проверять: проверять
программа: программы
программирование: программирования Программирование
программист: программисту программисты программистам
продвинуть: Продвинутые
продолжить: продолженная
проект: проектами Проект проекта проектов
проектирование: проектирования
производительность: производительности
происходить: происходит
пройтись: пройдёмся
промежуточный: промежуточное
простой: проще простой
протяжение: протяжении
профиль: профилей
процедура: процедуры
процедурный: процедурных Процедурные процедурный процедурного процедурным
прямой: прямого
публикация: Публикация
публиковать: публикуете
путь: Пути путей путём
пять: пяти
работа: Работа работы работу
работать: работает работают
рабочий: Рабочие рабочем
раз: раз раза
разбирать: разбирает разбирать
разбираться: разбирается
разбор: разбор разборе
раздел: разделе
разделитель: разделитель
разделить: разделили
разделять: разделяемого
различие: различие различия
различный: различных различные
разница: Разница
разный: разных
разобрать: разобранный разобрали
разработка: Разработка разработки
ранее: ранее
раскрываться: раскрываются
распознать: распознать
распоряжение: распоряжении
рассказать: рассказано
рассмотреть: рассмотрим рассмотренного
расти: растущими
расширение: Расширение
расширить: Расширенные
расширять: Расширяемый
реализация: Реализация реализацию реализации реализацией
реализовать: реализовать реализован реализующий
реализовывать: реализовывали
реализуете: реализуете
редакция: Редакции
результат: результат результата
ресурс: ресурсам
рефакторинг: Рефакторинг
рефлексия: рефлексии
решение: решение
реэкспортировать: реэкспортирует
сайт: сайт
самостоятельно: самостоятельно
самый: самое
свой: своё своей своих свой своему свои
связать: связанных связанными связаны связанный связанного
сгенерировать: сгенерирован сгенерированный сгенерируем сгенерировать
сделать: сделать сделаем
себя: собой
семейство: семейству
сервер: сервера сервер
сигнатура: Сигнатура сигнатуру
символ: символы символ символу
синтаксис: Синтаксис синтаксиса
синтаксическа: синтаксически
синтаксический: синтаксический синтаксического
система: системе
ситуация: ситуации
скобка: скобок скобках
скобки: скобки
сколько: сколько
скомпилироваться: скомпилируется
следовать: следуют следует
следующий: следующий следующая следующим следующее
слово: слова словами
сложный: сложными сложные сложных сложной
случай: случае
смочь: смогли сможет
смысл: смысл
сначала: сначала
собрать: соберут
собственный: собственном
совпадать: совпадающее
совпадение: совпадении
соглашение: Соглашение
содержать: содержащий содержит содержать содержащего
содержимое: содержимого
создавать: создаёте создаёт создают создаваемый создаём создавать
создаваться: создаётся
создайте: Создайте
создание: создание создания создании
создать: создадим создать
сообщение: сообщений сообщения
соответствие: соответствия
соответствовать: соответствовать соответствующий соответствующие соответствует
сопоставить: сопоставлен
сопоставление: сопоставление сопоставления сопоставлению
сопоставлять: сопоставляют сопоставляемой
сопоставляться: сопоставляются
состояние: состоянием
специальный: специального
список: списков
способ: способом способ
справочник: Справочнике справочник
сравнение: Сравнение
сравнивать: сравнивают
сравниваться: сравниваются
среда: среды
срез: среза срезов
срок: сроков
ссылка: Ссылки ссылок ссылками
ссылочные: Ссылочные
стандартный: стандартной
статья: статьи
сторона: стороны стороной
строка: строками строки строку
строковый: строковых строковый
структура: структур структуры структурами Структура структуру структуре
структурирование: структурировании
структурировать: структурировали
суть: сути
существовать: существует
схожий: схожим
так: так
также: также
такой: такое такие таким такой
текст: текста
тело: тело теле тела
теперь: Теперь
термин: Термин
тесно: тесно
тест: тестов тесты
тестирование: тестирование
технический: технических
тип: Типы Тип типов типа типом типу
типаж: типажи типажей типаж типажа
токен: токенов токены
тот: того то том тому Тем
требовать: требуемого
трейт: трейта трейтов трейт
трейты: трейты
три: три трём трёх
труднее: труднее
увидеть: увидите увидеть
угодно: угодно
удобнее: удобнее
узнать: узнать
указание: указания
указатель: указатели указателями указатель
указать: указанные указали указать
указывать: указывают указывает указывающие указываете
улучшение: улучшения Улучшение
уменьшение: уменьшения
умный: Умные умными умный
умолчание: умолчанию
упоминаться: упоминаются
управление: управления Управление
управлять: Управляющие управляющими
упростить: упростили
упрощать: упрощают
упрощенный: упрощённое Упрощённая
успешно: успешно
установка: Установка
устранимые: Устранимые
устранить: устранены
утечка: утечке
учитывая: Учитывая
файл: файла файлов файле Файл
фактический: фактическое
фигурный: фигурные
фиксироваться: фиксируются
финальный: Финальный
форма: формой форма формы
фреймворк: фреймворка
функционал: функционал
функционально: функционально
функциональность: функциональности функциональность
функциональный: Функциональные
функция: Функции функций функциями Функция функцию
фух: Фух
характеристика: характеристики
хотеть: хотел хотим хотят хотели хотите
хранение: Хранение
целый: целых
цель: цели
цикл: циклы
часто: часто
часть: части часть
человек: людей
число: число числа чисел
читать: читать
чтение: Чтение
что: чего Что чем
шаблон: шаблона Шаблоны шаблон шаблонами шаблоном шаблонов шаблону шаблоне
шаг: шаг шагом
широко: широко
экземпляр: экземпляров Экземпляр
экономить: экономит
элемент: элемент элементов элемента элементы элементам
этап: этапе
это: Это этого
этот: этой эти этих Этот этим этом эту
являться: являются является
ядро: ядро
язык: Язык языка языков
