абстрагировать: абстрагирует
адаптер: адаптеров адаптера адаптер адаптеры
аргумент: аргумента аргументов
беспокоиться: беспокоиться
библиотека: библиотеки
более: более
большинство: Большинство
будущее: будущем
быстрый: быстрее
быть: было будем будет была быть
ваш: вашего
ввод: вводом ввода
вектор: вектор вектора вектору векторы
вернуть: вернуть
версия: версию
весь: все
вид: виде
владение: владение
владеть: владеть владеет владел владеем
возвратить: возвращённого возвращённым
возвращать: возвращаемого возвращает возвращающим возвращаемых возвращаемым возвращаем
возвращаться: возвращается
возиться: возиться
вооружиться: Вооружившись
вопрос: вопрос
воспользоваться: воспользоваться
воспроизвести: воспроизвели воспроизведена
временной: временного
время: время
вы: вы
выбор: Выбор
выбрать: выбрать
вывод: выводом вывода
выглядеть: выглядеть выглядела
выделение: выделение
вызвать: вызвать
вызов: вызовах
вызывать: вызывать вызываем
высокоуровневый: высокоуровневой
глава: главы
говорить: говорили
гораздо: гораздо
давать: Давайте
далее: Далее
данные: данных
два: две
действительно: действительно
делать: делает делаем делают
длина: длину
добавить: добавили добавить
документация: Документация
должный: должен должны
досрочно: досрочно
доступ: доступом
другой: другой
еще: ещё
задать: задано
заимствование: заимствования заимствованием
затем: затем
здесь: здесь
знание: знаниями знаниям
знать: знаем
значение: значений значениями значениям значения значение значению значением
избежать: избежать
извлечение: извлечения
изменение: изменение
изменить: изменить изменим
изменяемый: изменяемым Изменяем изменяемого
изменять: изменять
иметь: имел
имя: имя
индекс: индексу индексов
индексация: индексации
индексирование: индексирования
интуитивный: Интуитивно
использование: Использование использования использованием
использовать: используем использовать использует используя
итератор: итераторах итераторы итератор итератора итератором итераторов итераторами итераторе
итерация: итерации
каждый: каждый
какой: какой
качество: качестве
клонирование: клонирования
клонировать: клонировать
ключевой: ключевое
код: коде код кода
количество: количество
компилироваться: компилироваться
концепция: концепции
который: который которая которое которые которых
лаконичный: лаконичными
легче: легче
листинг: листинге Листинг листинга
логичный: логичный
любой: любым
место: места
метод: методов метод метода методы
минимизировать: минимизировать
можно: можно
мочь: можем могут может
мы: мы Нам нас
назначение: назначение
наличие: наличия
написать: написать
напомнить: Напомним
напрямую: напрямую
начало: начало
наш: нашего нашу нашим нашем
недостаточно: недостаточно
некоторый: некоторые
немного: немного
неэффективный: неэффективных
низкоуровневый: низкоуровневый
ничто: ничего
новый: новым новое новые
нужный: нужно
обновить: обновим обновить обновили обновлён
обновление: Обновление
образ: образом
обращаться: обращается обращаться
обсуждать: обсуждали
обычный: обычного
ограничить: ограниченный
одновременный: одновременным
ожидать: ожидаемого
означать: означает
он: ним его него
она: она ею
они: их они
операция: операции операциями
определение: определение определения
определенный: определённым
оригинальный: оригинальную
открыть: Откройте
память: памяти
параллельный: параллельным
параметр: параметре параметра параметр параметры
первый: первое
передавать: передавать передаём
передача: Передача
перейти: перейти
переменный: переменные
переместить: переместить
перестать: перестанет
поговорить: поговорим
подправить: подправим
позволить: позволит позволить
позволять: позволяя
поиск: поиск
пока: пока
показать: показано
показывать: показывает
поле: поле
получить: полученными получит получить
поместить: поместить
помните: Помните
помощь: помощью
понадобиться: понадобился
понятнее: понятнее
понятный: понятными понятным
понять: понять
поскольку: Поскольку
потому: потому
почему: почему
почувствовать: почувствуете
поэтому: поэтому
предположить: предположить
предпочитать: предпочитает предпочитают
преимущество: преимуществами
признак: признак
прийти: пришло
прийтись: пришлось придётся
применять: применяя
пример: примеру
принимать: принимает принимала
проверять: проверяет
программа: программы
программирование: программирования
программист: программистов
проект: проекта проекте
проигнорировать: проигнорировать
производительность: производительности
пройти: пройти
процесс: процессе
проще: проще
путь: путём
работа: работы
раздел: разделе
различный: различные различными
разобраться: разобраться
ранее: Ранее
распоряжение: распоряжение
рассмотреть: рассмотрим
реализация: реализацию Реализация реализации
реализовать: реализует
реализующим: реализующим
репродукция: Репродукция
самый: самое
свой: своё своём
сделать: сделать
сжатый: сжатом
сигнатура: сигнатуру сигнатуры
синтаксис: синтаксиса
скомпилироваться: скомпилируется
следующий: следующим следующему Следующий
слово: слово
сложный: сложно
смочь: сможем
сначала: Сначала
собирать: собирать собираем
совпадать: совпадающие
содержать: содержат
содержимое: содержимое
создавать: создаёт создавать
состояние: состояния
сохранить: сохранить
сперва: сперва
спецификация: спецификацию
срез: срез среза
стандартный: стандартной
стать: станет
стесняться: стесняйтесь
стиль: стиль
стоить: стоит
строка: строки
структура: структуры структуре
так: так
также: также
такой: Такое такие
тело: тело
теперь: теперь
тип: тип типом
типаж: типажа
тот: того То те
трейт: Трейты
трейтом: трейтом
увидеть: увидеть
удаление: Удаление
удалить: удалим
удалять: Удаляем
улучшение: Улучшение
улучшить: улучшить
универсальный: универсальный
уникальный: уникальные
управлять: управлять
условие: условие
файл: Файл файле
фильтрация: фильтрации
фокусироваться: фокусируется
функциональность: функциональность
функциональный: Функциональный
функция: функции функция функцию
хороший: лучше
хотеть: хотим
цель: цели
цикл: циклами цикла цикл
часть: часть
что: что
эквивалентный: эквивалентны
экземпляр: экземпляр
элемент: элементами элементы элемент
это: это этого
этот: этими этот эти
язык: языке
