автоматический: автоматических
анонимный: анонимные
аргумент: аргументов аргументами аргумента
безбоязненный: Безбоязненный
библиотека: библиотеки библиотеке
билд: билдов
бинарный: бинарных
большинство: большинстве
буква: буквой
быть: есть быть было будет
валидация: Валидация
вариант: варианта
ваш: ваши
введение: Введение
ввод: вводом
веб: веб
вектор: векторами вектора вектор
вернуть: вернуть
весь: Все всего
взаимодействие: взаимодействие
видеть: видели
видимость: видимости
владение: владения владение
вместо: вместо
внешний: внешним
внимание: внимание
внутренний: внутренняя
возврат: Возврат
возвращать: возвращаемые возвращающую возвращает возвращать возвращаемого
возможность: возможности возможностей
время: время
всегда: всегда
вспомните: Вспомните
вход: вход
вы: вы вам
вывод: выводом
выводимые: Выводимые
выводить: выводит
выглядеть: выглядит
выделить: выделить
вызвать: вызвать
вызывать: вызывает
вызываться: вызывается
выполнение: выполнением Выполнение выполнения
выпуск: выпуска
где: где
глава: главы
говорить: говорили
давать: давайте
далее: Далее
данные: Данных данные
два: два
дважды: дважды
действие: действия
демонстрироваться: демонстрируется
дерево: дереве
диапазон: диапазоне
добавление: добавления
добавлять: добавляет
должный: должны
дополнительный: дополнительной
допускать: допускающих допускают
доступный: доступно
другой: других
единица: единицу
единственный: единственный
жизнь: жизни
завершение: завершение
загадка: загадки
заимствование: заимствование
закодировать: закодированного
замыкание: замыкания замыканиям замыкание замыканий замыканиями
запись: Запись
затем: затем
захватывать: захватывают
захотеться: захочется
здесь: Здесь
знать: знает
значение: значений значениями значения значение
игра: игры
изменяемость: изменяемость
именовать: именованную
иметь: имеет
имя: имя именем
инициализатор: инициализатором инициализаторы инициализатора
инструмент: инструменты
информация: информации
использование: Использование
использовать: использующей использовать используем используя используйте
использоваться: использоваться используется
итератор: итераторы итераторов
каждый: каждого каждое
качество: качестве
ключ: ключей
ключевой: ключевого Ключевые
книга: книги
код: кода код кодом
коллекция: коллекции
команда: команд
командный: командной
комментарий: Комментарии
компилироваться: компилируется
компилятор: компилятора
конкретный: конкретный конкретного
конструкция: конструкции Конструкция
конфиденциальность: конфиденциальностью
концепция: концепции
который: которые которая который котором которым
крейт: крейтов крейты крейта
куча: куче
лаконичный: Лаконичный
листинг: листинге Листинг
лучше: Лучше
любой: любую любого любой
макрос: Макросы
место: места месте
метод: метода методов
мир: Мир
многопоточный: многопоточного многопоточный
модуль: модулей
модульность: модульности
можно: можно
мочь: могут может можем можете могли
мы: Мы нами
мягкий: Мягкое
называться: называется
написание: Написание
например: например
напрямую: напрямую
настройка: Настройка
начать: начать
наш: нашего
небезопасный: Небезопасный
некоторый: некоторые
непосредственно: непосредственно
несколько: несколько
нет: нет
неустранимый: Неустранимые
новый: новое
нужный: нужно
оба: Оба
обеспечение: обеспечения
область: областью область области
обобщенные: Обобщённые
обработка: Обработка обработки
образ: образом
образец: образцом
обратите: Обратите
обратиться: обратитесь
обсуждать: обсуждали
общий: Общие общим
объединение: объединения
объект: объектов объект объектах
объектный: объектно
объявлять: объявляем
обычный: обычными обычные
один: одним один
однако: Однако
однопоточный: однопоточного
ожидать: ожидает
означать: означает
окружение: окружение
он: он
она: ей
они: них
оператор: Операторы
описание: описания
определение: Определение
определенный: определённую
определить: определили определённого
определяемое: определяемое
определять: определять
опровержимость: Опровержимость
организация: Организация
ориентировать: ориентированного ориентированных
отличие: отличие
отлично: отлично
относиться: относящиеся
очистка: очистке очистка
ошибка: ошибок ошибки ошибках Ошибка
пакет: пакетов Пакеты
память: памяти
параллелизм: параллелизм
параллельный: параллельного
параметр: параметр параметру параметра
первый: первого
перевод: Переводы
передавать: передавать передавая
передать: передать переданному
передача: передачи Передача
переменный: Переменные переменными
пересылка: Пересылка
перечисление: Перечисления перечислений
писать: писать
поведение: поведения
подобный: подобного
подробнее: Подробнее
подсчет: подсчётом
позволять: позволяет
полезный: Полезные полезна
полный: полный
получение: Получение получения
получить: полученные
пользовательский: пользовательских
помощь: помощью
понимание: Понимание
понятнее: понятнее
последовательность: последовательности
посмотреть: посмотрим
поток: потока поток потоков потоками
потому: потому
поэтому: поэтому
превращение: Превращение
предисловие: Предисловие
предоставлять: предоставляемого
предпочитать: предпочитают
представить: представлены
преобразование: преобразования
привести: привести
привет: Привет
приложение: Приложения
пример: Пример примеров примера
принимать: принимает принимающую принимать принимающих
проблема: проблемы
программа: программы
программирование: программирования Программирование
продвинуть: Продвинутые
проект: проектами Проект проекта
проектирование: проектирования
производительность: производительности
профиль: профилей
публикация: Публикация
путать: путать
путь: Пути путей
пытаться: пытается
работа: Работа работы
рабочий: Рабочие
раздел: разделе раздела разделу
разделять: разделяемого
разный: разных
разработка: Разработка разработки
ранее: ранее
рассматриваться: рассматриваются
рассмотреть: рассмотрим
расти: растущими
расширение: Расширение
расширить: Расширенные
расширять: Расширяемый
реализация: Реализация
реализовать: реализуют реализован реализующего реализующих реализующий
редакция: Редакции
результат: результаты
рефакторинг: Рефакторинг
решение: решение
свой: своё
связать: связанных связанными связанного
сделать: сделать
сервер: сервера сервер
символ: символы
синтаксис: Синтаксис
складывать: складывает
сколько: сколько
следующий: Следующий следующим
слово: слова
случай: случаев
снова: снова
создавать: создаём
создаваться: создаётся
создание: создание
создать: созданную
сообщение: сообщений
соответствовать: соответствовать соответствуют
сопоставление: сопоставление
состояние: состоянием
список: списков
сравнение: Сравнение
среда: среды
срез: среза
срок: сроков
ссылаться: ссылается
ссылка: Ссылки ссылок ссылками
ссылочные: Ссылочные
стандартный: стандартной
становиться: становится
стиль: стиль
строка: строками строки строк
строчный: строчной
структура: структур структуры
так: так
также: также
такой: такое такие такой
текст: текста
тело: теле
тест: тестов тесты
тестирование: тестирование
техника: техника
тип: Типы Тип типов типу типа типом
типаж: типажи типаже типаж
тот: того то тот
трейт: трейта трейтов трейт
трейтами: трейтами
трейтом: трейтом
трейты: трейты
три: три
уже: уже
указание: указания
указатель: указатели указателями указатель указателем указателей указателя
указать: указали
указывать: указываем
улучшение: улучшения Улучшение
умный: Умные умными умный
универсальный: универсального универсальный
управление: управления Управление
управлять: Управляющие
установка: Установка
устранимые: Устранимые
утечка: утечке
файл: файла файлов Файл
финальный: Финальный
функциональность: функциональности
функциональный: Функциональные
функция: функции функциям функций функцию Функция функцией
характеристика: характеристики
хотеть: хотите хотели
хранение: Хранение
цикл: циклы
человек: люди
число: число чисел
чтение: Чтение
что: чего Что
шаблон: шаблона Шаблоны шаблон
экземпляр: экземпляров экземпляры
элемент: элемент элементов
этот: этом Эта Этот эти этой
являться: является
язык: Язык языка языков языке
