программирование: Программирование программирования
игра: игры игру игра
загадка: загадки
язык: Язык языка языков
предисловие: Предисловие
введение: Введение
что: чего Что
начать: начать Начнём начала начнёт
установка: Установка
привет: Привет
мир: Мир
общий: Общие общим общими
концепция: концепции концепциями концепцию
переменный: Переменные переменными переменных переменную переменной Переменная
изменяемость: изменяемость
тип: Типы Тип типов типа типах типом типе
данные: Данных данные
функция: Функции функциях функция функцию функцией
комментарий: Комментарии комментарий комментариях
управлять: Управляющие
конструкция: конструкции Конструкция
понимание: Понимание
владение: владения владение
такой: такое таких таким такие
ссылка: Ссылки ссылок ссылками ссылкой ссылку
заимствование: заимствование
срез: среза
использование: Использование использованием использования использованию
структура: структур структуры
объединение: объединения
связать: связанных связанными связать связанное
определение: Определение
создание: создание создания
экземпляр: экземпляров экземпляр экземпляром экземпляра экземпляре
пример: Пример примеры примерах примеру примере
программа: программы программе программа программу программах программой
использовать: использующей использовать используем используя использующий используемого использующих использует
синтаксис: Синтаксис синтаксиса
метод: метода методах метод методы методов
перечисление: Перечисления перечисление перечислением
сопоставление: сопоставление сопоставления
образец: образцом
поток: потока поток потоков потоками
управление: управления Управление
лаконичный: Лаконичный
расти: растущими
проект: проектами Проект проекта проектом проекте проекты
помощь: помощью
пакет: пакетов Пакеты пакет пакета
крейт: крейтов крейты крейта крейт
модуль: модулей модуля
область: областью область области
действие: действия
конфиденциальность: конфиденциальностью
путь: Пути путей
элемент: элемент элементов
дерево: дереве
видимость: видимости
ключевой: ключевого Ключевые Ключевое
слово: слова слово словами
коллекция: коллекции коллекция
хранение: Хранение хранения
список: списков список списке
значение: значений значениями значения значению значение значением значении
вектор: векторами
закодировать: закодированного
текст: текста
строка: строками строки строку строке строка строкой строк
ключ: ключей
обработка: Обработка обработки обработку обработке
ошибка: ошибок ошибки ошибках ошибке
неустранимый: Неустранимые
устранимые: Устранимые
трейты: трейты
характеристика: характеристики
время: время
жизнь: жизни
обобщенные: Обобщённые
разделять: разделяемого
поведение: поведения поведение
валидация: Валидация
срок: сроков
написание: Написание
автоматический: автоматических
тест: тестов тесты
писать: писать
выполнение: выполнением Выполнение выполнения
организация: Организация
ввод: вводом ввода ввод вводе
вывод: выводом вывода Вывод
командный: командной
получение: Получение получения
аргумент: аргументов аргумента аргумент
чтение: Чтение
файл: файла файлов файл файлом файле файлу
рефакторинг: Рефакторинг
обеспечение: обеспечения Обеспечение
модульность: модульности
улучшение: улучшения Улучшение
разработка: Разработка разработки
функциональность: функциональности функциональность функциональностью
библиотека: библиотеки библиотеку Библиотека библиотеке библиотекой
тестирование: тестирование тестирования
работа: Работа работы работу
среда: среды
запись: Запись
сообщение: сообщений сообщение
вместо: вместо
функциональный: Функциональные функциональных функциональная
возможность: возможности возможностей возможность
итератор: итераторы итераторов
замыкание: замыкания
анонимный: анонимные
который: которые который которое которая которую которых которыми котором которой
захватывать: захватывают
свой: своё свою свои своём свой
окружение: окружение
последовательность: последовательности
наш: нашего нашем
сравнение: Сравнение сравнении сравнения
производительность: производительности
цикл: циклы цикл циклов цикла
подробнее: Подробнее
настройка: Настройка настройки
билд: билдов
профиль: профилей
выпуск: выпуска
публикация: Публикация
рабочий: Рабочие
бинарный: бинарных бинарный
расширение: Расширение
добавление: добавления Добавление
пользовательский: пользовательских пользовательский пользовательского
команда: команд команда команды команду
умный: Умные умными умный
указатель: указатели указателями указатель
указание: указания
куча: куче
обычный: обычными
трейт: трейта трейтов трейт
код: кода код коде кодом
очистка: очистке очистка
подсчет: подсчётом
внутренний: внутренняя
ссылочные: Ссылочные
мочь: могут может можете могли мог можем
привести: привести приведёт
утечка: утечке
память: памяти память
безбоязненный: Безбоязненный
параллелизм: параллелизм
параллельный: параллельного
пересылка: Пересылка
передача: передачи
состояние: состоянием состояний состояние
расширять: Расширяемый расширяемым
объектный: объектно
ориентировать: ориентированного ориентированных
объект: объектов
допускать: допускающих
разный: разных разным разные разное
реализация: Реализация
шаблон: шаблона Шаблоны шаблон шаблону шаблоном
проектирование: проектирования
весь: Все Весь всё всего всю всеми всех
место: места место месте местом
где: где
использоваться: использоваться используется
опровержимость: Опровержимость
соответствовать: соответствовать соответствуют соответствует
расширить: Расширенные
небезопасный: Небезопасный
продвинуть: Продвинутые
типаж: типажи Типаж
макрос: Макросы макрос
финальный: Финальный финальной
многопоточный: многопоточного многопоточный
веб: веб
сервер: сервера сервер
однопоточный: однопоточного
превращение: Превращение
мягкий: Мягкое
завершение: завершение завершения
приложение: Приложения
оператор: Операторы оператора оператор
символ: символы Символ символами
выводимые: Выводимые
полезный: Полезные полезных полезно
инструмент: инструменты
редакция: Редакции
перевод: Переводы
книга: книги
создаваться: создаётся
программировать: Программируем
давать: Давайте дающую
окунуться: окунёмся
вместе: вместе
поработав: поработав
практический: практическим практический
этот: этой эти этом Этот Эта эту этого этих
глава: главе главах главы Глава
вы: вы вам вас
познакомиться: познакомитесь
несколько: несколькими нескольким несколько нескольких
показать: показав показано показан показанный
они: их они них
реальный: реальной реальный
узнать: узнаете
ассоциированный: ассоциированных ассоциированной Ассоциированная
внешний: внешних внешнюю
контейнер: контейнерах
многий: многом многих многими
другой: другом другие других другими другой другая другое
следующий: следующих следующей Следующая следующую следующее следующим следующий
мы: мы нам нами нас
рассмотреть: рассмотрим
идея: идеи
более: более
подробно: подробно
попрактиковаться: попрактикуетесь
основа: основах
реализовать: реализуем реализованная реализующие
классический: классическую
начинающий: начинающих
программист: программистов
задача: задачу задача Задачей
вот: Вот
это: это этим
работать: работает работаем работать работают
генерировать: генерирует
случайный: случайное случайных случайного случайные
целый: целое
число: число числа чисел числами числом
диапазон: диапазоне диапазона
затем: Затем
она: она её
предлагать: предлагает
игрок: игроку
он: его нем он ему него
угадать: угадать угадал угадано угадает
указать: укажет указанные указали укажете указать указано
меньше: меньше
больше: больше
быть: было будете есть быть будут будет будем была были был
загадать: загаданное загаданным
догадка: догадка догадки догадку догадок
верный: верна
напечатать: напечатает напечатаны
поздравительный: поздравительное
завершиться: завершится завершилась
новый: нового новый новую новое новым новой новые новых новая новыми
перейти: перейдите перейти перейдёт
каталог: каталог каталоге
создать: создали создайте созданный создала созданным создать
низкий: ниже
первый: Первая первого первой первую первом первый
принимать: принимает принимать
качество: качестве
имя: имя именем
второй: Вторая второй
изменять: изменяет изменяемым
заглянуть: Загляните
уже: уже
видеть: видели видите
создавать: создаёт создаём создаваемый создаёте создавать
посмотрите: Посмотрите
теперь: Теперь
скомпилировать: скомпилируем
сразу: сразу
этап: этапе
запустить: запустим запустить запущен
пригодиться: пригодится
когда: когда
необходимый: необходимо
ускоренно: ускоренно
выполнить: выполнить выполнен выполнит
итерация: итерацию итерации
так: так
собираться: собираемся
делать: делать делает
быстро: быстро
тестировать: тестируя
каждый: каждую каждой каждое каждом каждый
прежде: прежде
снова: Снова
открыть: откройте откроете
часть: часть частью частям части
запрашивать: запрашивает запрашивать
пользователь: пользователем пользователя пользователь пользователям пользователю
обрабатывать: обрабатывает обрабатывать
проверять: проверяет проверять
ожидать: ожидаемой
форма: форме форму
тот: того то том тем тех тот те
позволить: позволим позволит позволить
ввести: ввести введённых ввели введёт
вставьте: Вставьте
листинг: листинга Листинг листинге
получать: получает получаем
выводить: выводит
экран: экран
содержать: содержит содержащий содержала содержащее
много: много
информация: информации информацию информация
поэтому: поэтому
построчно: построчно
получить: получить получено получите получит полученное
вывести: вывести выведет
результат: результат результатом результата результате
нужный: нужно нужны нужной
включить: включить включили
являться: является являются
стандартный: стандартной стандартного стандартный стандартную
известный: известной
умолчание: умолчанию
набор: набор
определенный: определённых определённые
добавлять: добавляет добавляем
называться: называется
прелюдия: прелюдией прелюдии
изучить: изучить изучите
содержание: содержание
документация: документации документацию
требоваться: требуется
отсутствовать: отсутствует
явно: явно
предоставлять: предоставляет предоставляемый предоставляемую
ряд: ряд
включая: включая
способность: способность
отмечаться: отмечалось
точка: точкой
вход: входа
объявлять: объявляет
круглый: круглые
скобка: скобки скобка скобок
показывать: показывают показывает показывая
нет: нет
входной: входных входные
параметр: параметров
фигурный: фигурная фигурной фигурных фигурные
обозначение: обозначение
тело: тела тело
также: Также
упоминаться: упоминалось
ход: ходе
далее: Далее
становиться: становится
интереснее: интереснее
маленький: маленькой маленьких маленькое
сам: самом сам
дело: деле
происходить: происходит
очень: очень
многое: многое
еще: ещё
один: один одному одним одной одну одном одно одного
привязывать: привязывает
неизменяемый: неизменяемы
присвоить: присвоим
оно: оно
измениться: изменится изменились
обсудить: обсудим
раздел: разделе раздел
изменчивость: изменчивость
чтобы: Чтобы
сделать: сделать сделает
изменяемый: изменяемой изменяемую
примечание: Примечание
сочетание: сочетание сочетания
знак: знаков Знак знака
начинать: начинает начиная
продолжаться: продолжается
конец: конца конце
игнорировать: игнорирует игнорировать
находиться: находится находиться
возвращаясь: Возвращаясь
угадайк: Угадайка
знать: знаете знать знает знайте
предоставить: предоставит
равенство: равенства
сообщать: сообщает сообщая сообщаете
сейчас: сейчас
справа: Справа
вызов: вызова вызов вызове вызовом
возвращать: возвращающей возвращает возвращаемое возвращаемого возвращаемых
фрагмент: фрагментом фрагменту
кодировка: кодировке
указывать: указывает указываем указывающее указывать
данный: данном данный
случай: случае
пустой: пустую пустым пустые пустой
можно: можно
встретить: встретить
типичный: типичное
название: название
какой: какого какой каких какие какая
конечный: конечном
итог: итоге
связываться: связывается
фух: Фух
напомнить: Напомним
подключить: подключили
вызвать: вызовем вызвать вызовет
импортировать: импортировали
начало: начале
равный: равно равна
записать: записав запишет
представлять: представляющим представляет
дескриптор: дескриптор дескрипторе
ваш: вашего ваш вашим Ваши вашими
терминал: терминала
вызывать: вызывает вызываем вызывать
передавать: передаём
хранить: хранить
главный: Главная главных
принять: принять
вводить: вводит вводить
сложить: сложить
переписывать: переписывая
содержимое: содержимое
строковый: Строковый
должный: должен должно должны должна
изменить: изменить изменили изменим
доступ: доступ
необходимость: необходимости
копировать: копировать
раз: раз
сложный: сложная сложной
преимущество: преимуществ
безопасность: безопасность
простота: простота
дописать: дописать
понадобиться: понадобится
подробность: подробностей
пока: Пока
достаточный: достаточно
соответственно: Соответственно
написать: написать написали
описать: описаны
потенциальный: потенциального потенциальной
сбой: сбоя сбой
обсуждать: обсуждаем
третий: третью
обратите: обратите
внимание: внимание
прежний: прежнему
логический: логической
однако: Однако
длинный: длинную длинные
трудный: трудно
читать: читать
лучше: лучше
разделить: разделить разделённых
часто: часто
целесообразный: целесообразно
пробельный: пробельные
разбить: разбить
ранее: ранее
помещать: помещает
называть: называемое называем
возможный: возможных
вариант: вариантом Вариантами Вариант варианты
кодирование: кодирование
операция: операция
успешно: успешно
внутри: внутри
сгенерировать: сгенерированное сгенерировать
означать: означает
удаться: удалась
причина: причинах Причина
неудача: неудачи неудачу
любой: любого любую любой любые любом
иметь: имеют иметь имеет имел
отобразить: отобразит
передать: передали переданное
скорый: скорее
базовый: базовой
операционный: операционной
система: системы системе системой система
взять: возьмёт
удерживать: удерживает удерживают
вернуть: вернёт
себя: собой себе
количество: количество
байт: байтов
скомпилируется: скомпилируется
предупреждение: предупреждение
предупреждать: предупреждает
неиспользованный: неиспользованном
учесть: учла
возникновение: возникновения возникновении
правильный: Правильный правильное правильной
способ: способ способах
убрать: убрать
хотеть: хотим
аварийно: аварийно
завершить: завершить завершена завершит
проблема: проблемы проблему
восстановление: восстановления
заполнитель: заполнителей заполнителем заполнителе
закрывать: закрывающей
момент: момент
обсуждение: обсуждения обсуждении
думать: думайте
клешня: клешнях
краб: краба
печать: печати Печать
заключаться: заключаться заключается
вычисление: вычисления
выражение: выражения выражений выражение выражением выражении
поместить: поместите поместил
формат: формата
укажите: укажите
запятая: запятыми
порядок: порядке
выглядеть: выглядеть
протестировать: протестируем протестировать
запустите: Запустите
клавиатура: клавиатуры
печатать: печатаем печатает
генерация: Генерация
секретный: секретного секретное секретным
попытаться: попытается
играть: играть
слишком: слишком
включать: включает включаем
подобный: подобной
дополнительный: дополнительного
функционал: функционала
помните: Помните
исходный: исходного исходным исходной
исполняемый: исполняемым
библиотечный: библиотечный
предназначить: предназначен
исполняться: исполняться
координация: Координация
блистать: блистает
включив: включив
зависимость: зависимости зависимость зависимостями зависимостей
итак: Итак
добавить: добавьте добавите добавлены добавив добавить
внизу: внизу
заголовок: заголовком
секция: секции
обязательно: Обязательно
точность: точности
здесь: здесь
номер: номером номера
версия: версии версий версию версией версия версиями
иначе: иначе
урок: урока
заработать: заработать
следовать: следует
пора: пор
начаться: начнётся
зависеть: зависит
спецификатор: спецификатором
семантический: семантической
понимать: понимает
семантическое: семантическое
версионирование: версионирование
иногда: иногда
стандарт: стандартом
описание: описания
сокращение: сокращением
рассчитывать: рассчитывает
общедоступный: общедоступное
совместимый: совместимое совместимы
последний: последние последнюю последней
исправление: исправлений исправление
компилироваться: компилироваться
гарантироваться: гарантируется
высоко: выше
менять: меняя
ничто: ничего
собрать: соберём соберёте
увидеть: увидеть увидите увидит увидим
расположить: расположены
брать: берет
реестр: реестра реестр
копия: копией
участник: участники
экосистема: экосистемы экосистему
размещать: размещают
открытый: открытым
обновление: обновления Обновление
загружать: загружает
загрузить: загружены загрузил
захватить: захватил
загрузка: загрузки
компилировать: компилирует
иметься: имеющимися
вносить: внося вносили
никакой: никаких никакого
изменение: изменений изменение изменением
скомпилировал: скомпилировал
перекомпилировать: перекомпилирует
нечего: нечего
завершать: завершает
внесете: внесёте
тривиальный: тривиальное
сохранить: сохраните
два: две двух два двумя
обновлять: обновляет
сборка: сборку сборок
крошечный: крошечным
повторно: повторно
скачать: скачано
скомпилировано: скомпилировано
воспроизводить: воспроизводимых воспроизводимую
механизм: механизм
обеспечивать: обеспечивающий
пересобрать: пересобрать
артефакт: артефакт
кто: кто
собирать: собирает собирать
обратный: обратное
задать: заданы заданное задайте
например: Например
допустить: допустим
неделя: неделе
выходить: выходит
важный: важное важен
регрессия: регрессию
сломать: сломать
справиться: справиться
запуск: запуске запуска
определять: определяет определяющее
критерий: критериям
записывать: записывает
будущее: будущем
существовать: существует
там: там
выполнять: выполнять
выяснение: выяснению
заново: заново
позволять: позволяет позволяющие позволяя
автоматически: автоматически
остаться: останется
обновить: обновите обновить обновит
поскольку: Поскольку
храниться: хранится
остальной: остальным
захотеть: захотите
соответствующий: соответствующие
спецификация: спецификациям
искать: искать
релиз: релиз
появиться: появится
серия: серии
образ: образом
доступный: доступных
пересмотреть: пересмотрит
требование: требования
соответствие: соответствии
рассказать: рассказать
легко: легко
разработчик: разработчики
малый: меньшие
скомпоновать: скомпонованы
угадывание: угадывания угадывание
шаг: шагом шаг
сначала: Сначала
генератор: генераторы генератор
посередине: посередине
самый: самый
локальный: локальным
текущий: текущего
запускаться: запускается
определяться: определяется
нижний: нижнюю
верхний: верхнюю
граница: границы
запросить: запросить
непростой: непросто
разобраться: разобраться
инструкция: инструкциями
замечательный: замечательной
особенность: особенностью особенность
локально: локально
открывать: открывает
браузер: браузере
интересный: интересна
нажать: нажмите нажать
боковой: боковой
панель: панели
слева: слева
удалить: удалим удалит
конечно: Конечно
совсем: совсем
похожий: похоже
ответ: ответ
попробуйте: Попробуйте
отличный: Отличная
сравнить: сравнить
учтите: Учтите
объяснить: объясним
далекий: дальше
добавим: добавим
три: три
исход: исхода
величина: величин
пять: пять
сравнивать: сравнивает
вызываться: вызываться
сравниваться: сравнивается
возвращаться: возвращается
принятие: принятия
решение: решения
возвратить: возвращён
состоять: состоит
ветка: веток Ветка ветки ветке ветку
очередь: очереди
просматривать: просматривает
мощный: мощные
выразить: выразить
множество: множество
ситуация: ситуаций
столкнуться: столкнуться
гарантировать: гарантировать
раскрыть: раскрыты
сказать: Скажем
случайно: случайно
просмотреть: просмотрит
проигнорировать: проигнорирует
заканчиваться: заканчивается
успешный: успешного
совпадение: совпадения совпадение
сценарий: сценарии
рассматривать: рассматривать
попробовать: попробуем
суть: Суть
наличие: наличии
несовпадающий: несовпадающих
строгий: строгая
статический: статическая
смочь: смог сможет
заставить: заставил заставить заставим
сторона: стороны
числовой: числовой числового числовые числовых
битный: битное
беззнаковый: беззнаковое
иной: иное
преобразовать: преобразовать преобразует преобразованы
считываемую: считываемую
подождать: подождите
затенять: затенять
предыдущий: предыдущее
затенение: Затенение
избежать: избежать
уникальный: уникальных
связывать: связываем
относиться: относится
вид: виде виду
сопоставить: сопоставить
добавиться: добавится
набирать: набирает
нажимать: нажимает
нажатие: нажатие
сопровождаться: сопровождается
возврат: возвратом
каретка: каретки
убирать: убирает
оставлять: оставляя
преобразование: преобразования
сообщить: сообщить
точный: точный
двоеточие: Двоеточие
после: после
говорить: говорит говоря говорим
аннотировать: аннотируем
встроить: встроенных
хороший: хороший
выбор: выбор
небольшой: небольшого
положительный: положительного
кроме: Кроме
аннотация: аннотация
логически: логически
невозможный: невозможно
потерпеть: потерпеть
обсуждаться: обсуждалось обсуждаются
точно: точно
вновь: вновь
хорошо: Хорошо
несмотря: Несмотря
пробел: пробелы пробела
понять: поняла
проверить: проверить
различный: различных
правильно: правильно
большой: большое
больший: большая
бесконечный: бесконечный
дать: дать
шанс: шансов
переместить: переместили
подсказка: подсказки
забыть: забудьте
четыре: четыре
отступ: отступы
бесконечно: бесконечно
фактически: фактически
выйти: выйти
прервать: прервать
клавиша: клавиш
спастись: спастись
ненасытный: ненасытного
монстр: монстра
говориться: говорилось
нечисловой: нечисловой нечисловом
воспользоваться: воспользоваться
выход: выходу Выход
заметить: заметите
мягко: мягко
оптимально: оптимально
остановиться: остановилась
запрограммировать: запрограммируем
выигрыш: выигрыше
заставлять: заставляет
недопустимый: недопустимого
улучшить: улучшить
аварийный: аварийного
факт: факт
продолжить: продолжить
преобразоваться: преобразуется
игнорирование: Игнорирование
запрос: запрос
заменять: заменяем
произвести: произвёл
внутрь: внутрь
оказаться: окажется
способный: способен
превратить: превратить
подробный: подробную
совпадать: совпадает
подчеркивание: Подчёркивание
всеохватывающий: всеохватывающим
обработать: обработать
независимо: независимо
эффективно: эффективно
положить: положено
потрясающе: Потрясающе
правка: правки
закончить: закончим
подходить: подходило
портить: портит
окончательный: окончательный
полный: полный
поздравлять: Поздравляем
заключение: Заключение
познакомить: познакомить
охватывать: охватывает
понятие: понятия
большинство: большинстве
рассматриваться: рассматривается
отличать: отличает
объясняться: объясняется
