автор: автора
администратор: администратора администратором
адрес: адресу адресе адрес адресами
аннотация: аннотацию
байт: байтами байт байты
беспокоиться: беспокоиться
библиотека: библиотека библиотеки
блок: блоки блок блоков
более: более
больше: больше
больший: большего
большинство: большинстве большинство
браузер: браузере браузер браузера Браузеры
буферизация: буферизацию
быть: есть будем будет будучи будут были быть было был
важный: Важным важна
вариант: вариантов
ваш: вашему вашей вашего
ввести: ввести
ввод: ввода
веб: веб
вектор: вектор
вернуть: вернуть вернём
версия: версии версия версию
весь: все весь
взгляд: взгляд
взглянуть: взглянуть
видеть: видите видеть видим видели
видимость: видимости
вкладка: вкладке
включить: включить
внести: внесли
внимание: внимание
возврат: возврат
возвращать: возвращает возвращал возвращать возвращают
возвращение: Возвращение
возможный: возможно
возникновение: возникновения
возникнуть: возникли
временной: временной
время: время
вручную: вручную
всякий: всякий
второй: Второй
входить: входящие входящий входящих
вы: вам вы вас
выборочный: выборочное
выбрать: выбрали
вывести: выведет выведенный
вывод: вывода вывод
выглядеть: выглядел выглядеть
вызвать: вызвав
вызов: вызова вызовами вызов
вызовите: Вызовите
вызывать: вызываем
вынести: вынеся
выполнение: выполнение выполнении
выполниться: выполнится
выполнять: выполняет
выполняться: выполняться выполняется
выходить: выходит
выше: выше
гарантировать: гарантировать
где: где
генерировать: генерирует
гипертекст: гипертекста
глава: главе
глядя: Глядя
го: го
давать: давайте даёт
далее: далее
данные: данные данных
данный: данном
дать: даст
два: Двумя двум два
двоеточие: двоеточием
действие: действием
действительный: действительный
делать: делать делает
дело: деле
день: дней
дескриптор: дескриптор
деструктурирование: деструктурирование
деталь: детали
детальный: Детальное
дл: Дл
добавить: добавьте добавим добавить добавили добавленном
добавлять: добавляем добавляет добавляя
документ: документ
должный: должно должны должна должен
доступ: доступ
другой: другому другими другим других другого другой другая другие
дублировать: дублированный
его: его
еще: ещё
забирать: забираем
заблагорассудиться: заблагорассудится
заботиться: заботится
забыть: забудьте
завершение: завершения завершении
завершиться: завершиться
зависеть: зависят
зависимость: зависимости
заголовок: заголовками заголовки заголовков заголовком заголовок
загрузить: загрузите
задействовать: задействованных
заканчиваться: заканчивается
заключаться: заключается заключаться
закончить: закончите
закрывать: закрывает
закрываться: закрывается
закрыть: закрыты закрытые
заменить: заменить
заменять: заменял
записать: записана запишем
записывать: записывать записывают
запись: Запись записи
запрашивать: запрашивают запрашивает
запрос: запрос запросы запросов запросами запроса запросом запросу
запросите: запросите
запросить: запросить запросил запрошено
запуск: запуска запуске
запустить: запустим запустить Запустите
затем: затем
захотеть: захотим
здесь: здесь
знакомый: знакомым
знать: знаем
значение: Значение значения
значить: значит
значок: значок
игнорировать: игнорируем
идентификатор: идентификатор идентификатором
идти: идёт идут
изменение: изменений изменениями изменения
изменить: Измените изменим изменить
изменяемый: изменяемую
изменяться: изменяются
изящно: изящно
иметь: имеют имеет
имя: имени
иначе: иначе
инициировать: инициирует
иногда: Иногда
инструкция: инструкции инструкцию
информация: информацию информация
исполнение: исполнении
использовать: используемыми использовать Используя используем используемый использовал использует используемую использовали
использоваться: используется
исправить: исправим
итератор: итератор итератора итераторе
каждый: каждом каждое каждого
какой: каким какие какой
каретка: каретки
каталог: каталога каталоге
качество: качестве
клиент: клиент клиенту клиентом клиента
книга: книги
когда: Когда
код: код кода кодом коде
количество: количество
команда: команду командой
компьютер: компьютеру компьютере компьютер
конец: конце
конечный: конечному
конкретнее: конкретнее
конкретно: конкретно
конкретный: конкретный
контент: контент контентом
конфликтовать: конфликтовать
корн: корне
корневой: корневого
кортеж: кортеже
который: который которой котором которые которых которая которую
красивый: красивое
краткий: краткий
крошечный: крошечный крошечного
лаконичный: лаконичным
легкий: легче
лимит: лимита
листинг: листинга Листинг листинге
любой: любые любом любой любым
маловероятный: маловероятно
машина: машине
машинка: машинок
медленный: медленных
место: место
метод: метода методов
метода: Метод
многий: многие
многое: многом
модифицировать: модифицировать
модуль: модуль
момент: момент
мочь: можем может могут могли можете мог
мы: Мы нам нас
мысленно: мысленно
набор: набор
набрать: набранное
нажать: нажав
называться: называется
найти: найден
наличие: наличие
напечатать: напечатает напечатаны напечатанных
написание: Написание
написать: написали
например: например
настоящий: настоящее
настроить: настроить
находиться: находится
начало: начало
начать: Начнём начать начала
начинать: начиная
наш: Нашему наш нашей наша наших нашем нашего наши
независимо: независимо
некоторый: некоторые
немного: немного
необработанный: необработанными
необходимый: необходимую необходимо
непосредственно: непосредственно
несколько: несколько
нет: нет
нижний: нижнего
никакой: никаких никакого
новый: новый новые новую новой
нужный: нужно
оба: Оба
обзор: обзор
область: области область
обнаружиться: обнаружится
обновление: обновления
обозначать: обозначает
оборачивать: оборачивает
обрабатывать: обрабатывать обрабатывают Обрабатываем обрабатывает
обработка: обработке обработка обработки обработку
образ: образом
обратите: Обратите
обратно: обратно
обслуживать: обслуживать
обсуждаться: обсуждалось
объемный: объёмных
обычно: обычно
обычный: обычным
ограничение: ограничение
ограничить: ограничен
один: одного один одно одном
одинаковый: одинаковый
одновременно: одновременно
однопоточный: однопоточного
означать: означает
окончание: окончании
он: он ним ему него
она: она ей
они: они их
операционный: операционной операционные
операция: операция
описание: описание
описывать: описывает
определенный: определённой
определять: определяет определяя
определяться: определяется
опять: Опять
основный: основными
остальной: остальных остальные
останавливать: останавливает
остановить: остановить
остаться: оставшиеся
отбрасываться: отбрасывается
ответ: ответ ответов ответами ответа Ответы ответе ответом
ответить: ответить
отвечать: отвечает Отвечаем
отдельный: отдельные
отделять: отделяет
открытый: открытое открытых
отладочный: отладочное
отличаться: отличаться отличающееся отличается
отличие: отличия
относиться: относящийся
отображать: отображаемой
отображаться: отображаться отображается
отправить: отправил отправленные отправим отправить
отправка: отправки отправку Отправка
отправлять: отправляет отправляя отправляем отправлять
очень: очень
очередь: очереди
ошибка: ошибок ошибки ошибке ошибкой ошибку
ошибочный: ошибочном
первый: первая первой Первый первую
перебирать: перебираем
перевод: перевода перевод
передавать: передаём
передаваться: передаётся
передача: передачи передачей
перезапустите: перезапустите
переменный: переменную переменной переменным переменные
печатать: печатаем печатал
печать: печать печати
писать: пишем писать пишущих
поведение: Поведение
повторно: повторно
повторять: повторяя
повторяться: повторяющиеся повторяются
подавлять: подавляющем
поддерживать: поддерживать
подключаться: подключается подключался
подключение: подключение подключения подключений
подключиться: подключиться
подобный: подобных подобную
подряд: подряд
позволять: позволяют позволяет
пока: пока
показать: показан показано
полный: полный
получатель: получателю
получать: получать получаем получает
получение: получении получением получения
получить: получили получить получим полученный получите
пользователь: пользователи пользователю
помощь: помощью
понять: понять
попадаться: попадается
попробовать: Попробуем
попробуйте: Попробуйте
попытаться: попытаемся попытаетесь
попытка: попытки
порт: портом порт порту порты
поскольку: Поскольку
последний: Последняя
последовательность: последовательность последовательностью последовательности
последующий: последующим
посмотреть: посмотрите посмотрев
посторонний: постороннее
потенциально: потенциально
поток: потоки поток потоков потока потоке
потому: потому
потрясать: Потрясающие
почему: почему
почти: почти
поэтому: поэтому
правильно: правильно
превышение: превышении
предлагать: предлагает
предоставить: предоставить
предоставлять: предоставляет
предполагать: предполагает
представлять: представляет
прежде: прежде
прежний: прежнему
прекращать: прекращать
прекращение: прекращения
преобразовать: преобразовать
привилегия: привилегий
приводить: приводить
привязка: привязка
приложение: приложении
пример: пример
примерно: примерно
принимать: принимает
принять: примет
присвоить: присвоены присвоить
пристальный: Пристальный
причина: причинам Причина Причиной причин причины
проблема: проблема проблемы проблемой
проверка: Проверка проверку
проверять: проверяет проверяем
программа: программы программа программу
проект: проект проекта
промышленный: промышленном
просить: просит
прослушивание: Прослушивание прослушивания
прослушивать: прослушивать прослушивающие
простой: простейший простой
простота: простоты
протокол: протоколов протоколами протокол протокола
процесс: процесс
прочий: прочие
пустой: пустой пустую
путь: путь пути
пытаться: пытается
работа: работы работу
работать: работать работает
равно: равно
равный: равна
раз: раз
разделить: разделить
разделять: разделяющий
размер: размер
разница: Разница разницу
разобрать: разберём
разобраться: разберёмся
рамка: рамки
ранее: ранее
распечатывать: распечатывать распечатываем
рассматривать: рассматривать
реализация: реализации
реализовать: Реализуем реализует
реальный: реальном реального
результат: результат результате
ресурс: ресурсов ресурса ресурс
рефакторинг: Рефакторинг
решить: решили
ряд: ряду
рядом: рядом
сам: самом
самый: самая самое самый
сбор: сбора
свежий: свежая
свой: свои свой своём
связать: связанные
сделать: сделаем сделайте сделать сделаете
себя: собой
сейчас: Сейчас
сервер: сервера серверов серверах сервер серверу сервером
серия: серию
сетевой: сетевой
сигнализировать: сигнализирует
символ: символа
система: системы
ситуация: ситуацию
скоро: скоро
следующий: следующем следующий Следующая
слово: слово
случай: случаев случае случаями
слушать: слушает слушать
смочь: сможем
сначала: сначала
снова: снова
собрать: собрать собрали
совсем: совсем
содержать: содержащая содержит содержали
содержимое: Содержимое содержимого
соединение: соединения соединение Соединением соединений
создавать: создавать создаём
создание: Создание создании создания
создать: Создайте создать
сообщение: сообщения сообщение сообщений
соответствовать: соответствуют соответствует
соответствующий: соответствующей соответствующие
состояние: состояния
состоять: состоит
состояться: состояться
спецификация: спецификация
способ: способом
сработать: сработает
ссылка: ссылку
стандарт: стандарту
стандартный: Стандартная стандартный стандартной
стесняться: стесняйтесь
страница: страницы страницу страницей
строиться: строится
строка: строк строки строку строкой строке строка строках
строковый: строковые
суммировать: суммирует
сформировать: сформированного
сценарий: сценарии сценария
считать: считать
сымитировать: сымитировав
так: так
также: также
таковой: таковых
такой: Таким таких
текст: Текст текстом
текстовый: текстовый текстовое
текущий: текущий
телефон: телефоне
тело: тела тело
теперь: теперь
термин: термин термином
терминал: терминале терминал
терминология: терминологии
технически: Технически
тип: типа типам тип
типаж: типажам типажа
тот: тем то того том тот той
требовать: требуемый
трейт: трейт
убедиться: убедиться
увидеть: увидеть увидим
удалите: удалите
уже: уже
указание: указанием
указатель: указатель
указывать: указываем указывает
уметь: умеет
унифицированный: унифицированный
управление: управления
управлять: управляя
уровень: уровня
успешно: успешно
успешный: успешного успешный успешном
установить: установлено установить установили
учебный: учебных
файл: файл файла файлы файлов
файловый: файловой
фактор: фактором
формат: формат
форматирование: форматирование
фраза: фразу
функционал: функционал
функциональность: функциональности
функция: Функция функцию функции
хотеть: хотим
целое: целом
цель: целях целей
цикл: цикл цикла цикле
часть: часть части
числовой: числовой
читать: читать читали читают
чтение: Чтение чтения чтением
что: что чего
шаблон: шаблон
экземпляр: экземпляр экземпляра
элемент: элемент элементов
это: это этого
этот: этих этой эти Этот этом этими
эффект: эффект
являться: являются является
