управление: Управление управления
выполнение: выполнением Выполнение выполнения выполнении
тест: тестов тесты тестами теста тест тесте тестом
язык: Язык языка языков
программирование: программирования Программирование
предисловие: Предисловие
введение: Введение
что: чего Что
начать: начать
установка: Установка
привет: Привет
мир: Мир
игра: игры
загадка: загадки
общий: Общие общим общего общее
концепция: концепции
переменный: Переменные переменными
изменяемость: изменяемость
тип: Типы Тип типов типа
данные: Данных данные
функция: Функции функция функцией
комментарий: Комментарии
управлять: Управляющие
конструкция: конструкции Конструкция
понимание: Понимание
владение: владения владение
такой: такое Таким
ссылка: Ссылки ссылок ссылками
заимствование: заимствование
срез: среза
использование: Использование использованием
структура: структур структуры
объединение: объединения
связать: связанных связанными
определение: Определение
создание: создание
экземпляр: экземпляров
пример: Пример
программа: программы программе
использовать: использующей использовать используемых используют использует используя
синтаксис: Синтаксис
метод: метода
перечисление: Перечисления
сопоставление: сопоставление
образец: образцом
поток: потока поток потоков потоками
лаконичный: Лаконичный
расти: растущими
проект: проектами Проект проекта
помощь: помощью
пакет: пакетов Пакеты
крейт: крейтов крейты крейта
модуль: модулей модуль модуле модуля
область: областью область области
действие: действия
конфиденциальность: конфиденциальностью
путь: Пути путей
элемент: элемент элементов
дерево: дереве
видимость: видимости
ключевой: ключевого Ключевые
слово: слова
коллекция: коллекции
хранение: Хранение
список: списков
значение: значений значениями значения значение значению
вектор: векторами
закодировать: закодированного
текст: текста
строка: строками строки строке строку
ключ: ключей
обработка: Обработка обработки
ошибка: ошибок ошибки ошибках
неустранимый: Неустранимые
устранимые: Устранимые
трейты: трейты
характеристика: характеристики
время: время времени
жизнь: жизни
обобщенные: Обобщённые
разделять: разделяемого
поведение: поведения поведение
валидация: Валидация
срок: сроков
написание: Написание
автоматический: автоматических
писать: писать пишет
организация: Организация
ввод: вводом
вывод: выводом вывод вывода выводе
командный: командной
получение: Получение
аргумент: аргументов аргументы аргумента
чтение: Чтение чтения чтением
файл: файла файлов файл
рефакторинг: Рефакторинг
обеспечение: обеспечения
модульность: модульности
улучшение: улучшения Улучшение
разработка: Разработка разработки
функциональность: функциональности
библиотека: библиотеки
тестирование: тестирование тестирования
работа: Работа работы работу
среда: среды
запись: Запись записью
сообщение: сообщений сообщения сообщением
вместо: вместо
функциональный: Функциональные
возможность: возможности возможностей
итератор: итераторы итераторов
замыкание: замыкания
анонимный: анонимные
который: которые который которое которая которого котором
захватывать: захватывают
свой: своё свой своего
окружение: окружение окружения
последовательность: последовательности
наш: нашего наших наши
сравнение: Сравнение
производительность: производительности
цикл: циклы
подробнее: Подробнее
настройка: Настройка
билд: билдов
профиль: профилей
выпуск: выпуска
публикация: Публикация
рабочий: Рабочие рабочий
бинарный: бинарных
расширение: Расширение
добавление: добавления
пользовательский: пользовательских
команда: команд команды команду команде команда командой
умный: Умные умными умный
указатель: указатели указателями указатель
указание: указания
куча: куче
обычный: обычными
трейт: трейта трейтов трейт
код: кода код коде
очистка: очистке очистка
подсчет: подсчётом
внутренний: внутренняя
ссылочные: Ссылочные
мочь: могут может можете можем
привести: привести
утечка: утечке
память: памяти
безбоязненный: Безбоязненный
параллелизм: параллелизм
параллельный: параллельного параллельном параллельное
пересылка: Пересылка
передача: передачи
состояние: состоянием состояния состояние
расширять: Расширяемый
объектный: объектно
ориентировать: ориентированного ориентированных
объект: объектов
допускать: допускающих
разный: разных разное
реализация: Реализация
шаблон: шаблона Шаблоны шаблон
проектирование: проектирования
весь: Все всех
место: места
где: где
использоваться: использоваться
опровержимость: Опровержимость
соответствовать: соответствовать соответствовали соответствует
расширить: Расширенные
небезопасный: Небезопасный
продвинуть: Продвинутые
типаж: типажи
макрос: Макросы макрос
финальный: Финальный
многопоточный: многопоточного многопоточный
веб: веб
сервер: сервера сервер
однопоточный: однопоточного
превращение: Превращение
мягкий: Мягкое
завершение: завершение
приложение: Приложения
оператор: Операторы
символ: символы
выводимые: Выводимые
полезный: Полезные
инструмент: инструменты
редакция: Редакции
перевод: Переводы
книга: книги
создаваться: создаётся
контролирование: Контролирование
ход: хода
тот: тому те то тем того
выполнять: выполняет
компиляция: компиляцию
ваш: вашего ваш ваши ваших
затем: затем
запускать: запускает запускаете запускать запускаем запускала
получить: полученный получите
двоичный: двоичный
компилировать: компилирует
режим: режиме
бинарник: бинарник
создавать: создаваемый создаёт
умолчание: умолчанию
параллельно: параллельно
перехватывать: перехватывает
генерировать: генерируемый
предотвращать: предотвращая
их: их
экран: экран
облегчение: облегчения
относиться: относящегося
результат: результатам результаты результатов Результат
однако: Однако
вы: вы вас
указать: указать указанное
параметр: параметры параметров параметра параметр
изменить: изменить
это: это этому
часть: Часть частью
передаваться: передаётся
итоговый: итоговый итоговых
разделить: разделить
этот: эти этот этого этом Эта
два: два двух
нужный: нужно
сначала: сначала
идти: идут
разделитель: разделитель разделителем
потом: потом
попасть: попадут
выводить: выводит
опция: опции
последовательно: последовательно
несколько: несколько нескольких
они: они них
выполняться: выполняются
означать: означает
завершиться: завершатся
быстрый: быстрее быстрыми
поскольку: Поскольку
должный: должны
убедиться: убедиться
зависеть: зависят
друг: друг друга другу
какой: какого какие
включая: включая
например: например
текущий: текущий
каталог: каталог
допустить: допустим
каждый: каждый каждом
диск: диске
имя: именем имени имена именами имя
записывать: записывает
некоторый: некоторые
считывать: считывает
утверждать: утверждает
содержать: содержит содержат
определенный: определённое
одновременно: одновременно
один: один Одно одному одного
перезаписать: перезаписать
промежуток: промежутке
другой: другим другое других
тогда: Тогда
второй: второй
потерпеть: потерпит
неудача: неудачу
потому: потому
неверный: неверен
мешать: мешали мешать
решение: решений решение
отдельный: отдельный
хотеть: хотите хотим
более: более
детальный: детальный
контроль: контроль
количество: количеством количество
можно: можно
установить: установить
флаг: флаг флагом
взгляните: Взгляните
следующий: следующий
мы: Мы нам нас
устанавливать: устанавливаем
тестовый: тестовых
равный: равным
указывать: указывая
занять: займёт
больше: больше
быть: будут будет был было были есть быть
совместно: совместно
демонстрация: Демонстрация демонстрации
пройти: пройден пройденного
система: система
запуск: запуска Запуск запуске
блокировать: блокирует
печать: печать
вызвать: вызовете
увидеть: увидите
консоль: консоль
вызов: вызова
информационный: информационные
также: также
описание: описание
вывести: выведены
пояснять: поясняющим
текстовый: текстовым
возвращать: возвращает
целочисленный: целочисленное
константный: константное
далее: Далее
следовать: следует
иметь: имеет
правильный: правильный
входной: входной
ошибочный: ошибочный
листинг: Листинг Листинга Листинге
обратите: Обратите
внимание: внимание
нигде: нигде
видеть: видим видеть
печататься: печатается
записать: записан
неудачный: неудачного
появляться: появляется
раздел: разделе
показывать: показывает показывал
причина: причину
напечатать: напечатанные
прохождение: прохождения
сказать: сказать
он: он
успешный: успешных
снова: снова
подмножество: подмножества
бывать: Бывают Бывает
случай: случаи
нет: нет
необходимость: необходимости
запустить: запустить запущен запущены запустив
работать: работаете
исследовать: исследуют
ее: её
удобный: удобно
сделать: сделать
передать: передав
качество: качестве
группа: группу
создать: создадим
показать: показано
постараться: постараемся
выбрать: выбрать
три: Три
различный: различными
выполнить: выполните выполнить
уточнять: уточняющих
выполниться: выполнятся
его: его
название: названием названию
давать: дают
понять: понять
образ: образом
первый: первое
способ: способ
фильтр: фильтров
любой: любой
отфильтровывать: отфильтровывала
становиться: становится
поэтому: поэтому
фильтруя: фильтруя
игнорирование: Игнорирование
требовать: требуют требующие
продолжительный: продолжительного
исполнение: исполнения
исключить: исключить
аннотировать: аннотировать
много: много
прогон: прогона
атрибут: атрибутом
здесь: здесь
после: После
добавлять: добавляем
теперь: Теперь
запускаться: запускается
игнорироваться: игнорируется игнорируются
пометить: помечена
проигнорировать: проигнорированные
воспользоваться: воспользоваться
управляя: Управляя
уверить: уверены
дойти: дойдёте
момент: момента
смысл: смысл
проверить: проверить
дождаться: дождаться
независимо: независимо
