абстракция: абстракций
автоматический: автоматических
анонимный: анонимные
аппаратный: аппаратным
аргумент: аргументов
аспект: аспект
безбоязненный: Безбоязненный
безопасность: безопасности безопасностью
безопасный: Безопасное
бесстрашный: бесстрашной Бесстрашная
библиотека: библиотеки библиотекой
билд: билдов
бинарный: бинарных
более: более
больше: больше
быть: было будет будем была были будут
важный: важными
валидация: Валидация
ваш: вашей
введение: Введение
ввод: вводом
веб: веб
вектор: векторами
весь: Все всё
видимость: видимости
владение: владения владение
вместо: вместо
внесение: внесения
внутренний: внутренняя
возможность: возможности возможностей
возможный: возможных
возникать: возникает
воспроизвести: воспроизвести
время: время временем времени
всякий: всякий
вы: вы вам
вывод: выводом
выводимые: Выводимые
выгода: выгоду
выполнение: выполнением Выполнение выполнения
выполняться: выполняются
выпуск: выпуска
высокий: высокого
гарантия: гарантии
где: где
глава: главе
данные: Данных данные
два: две
действие: действия
дерево: дереве
добавление: добавления
довольно: довольно
допускать: допускающих
доступ: доступ
еще: ещё
жизнь: жизни
завершение: завершение
загадка: загадки
заимствование: заимствование
закодировать: закодированного
заменить: замените
замыкание: замыкания
запись: Запись
запуск: запуска
захватывать: захватывают
здесь: здесь
значение: значений значениями значения
игра: игры
изменить: изменить
изменяемость: изменяемость
иметь: иметь имеют
инструмент: инструменты инструментов
использование: Использование использования
использовать: использующей используют Используя используем используемого
использоваться: использоваться
исправить: исправить
исторически: Исторически
итератор: итераторы итераторов
канал: каналы
ключ: ключей
ключевой: ключевого Ключевые
книга: книги книга
код: кода код
коллекция: коллекции
команда: команд команда
командный: командной
комментарий: Комментарии
компиляция: компиляции
компьютер: компьютеров
конкретный: конкретны конкретной
консервативный: консервативные
конструкция: конструкции Конструкция
контроль: контроля
конфиденциальность: конфиденциальностью
концепция: концепции
который: которые которых который
крейт: крейтов крейты крейта
куча: куче
лаконичный: Лаконичный
легко: легко
любой: любой любым
макрос: Макросы
меньше: меньше
место: места
метод: метода методами
мир: Мир
многий: многие
много: много
многопоточность: Многопоточность многопоточности многопоточностью
многопоточные: многопоточные
многопоточный: многопоточного многопоточный многопоточным Многопоточное многопоточными
множество: множество
моделирование: моделирования
модуль: модулей
модульность: модульности
мочь: могут может можете
мощный: мощным
мы: Мы
мысленно: мысленно
мягкий: Мягкое
набор: набором
надеяться: надеется
назвать: назвали
называть: называть
написание: Написание
например: Например
настройка: Настройка
начать: начать
наш: нашего
небезопасный: Небезопасный
независимо: независимо
некорректный: некорректный
некоторый: некоторого некоторому
необходимый: необходимо
несколько: нескольких несколько
неустранимый: Неустранимые
низкий: низкого
новый: новых
обеспечение: обеспечения обеспечение обеспечением
обеспечить: обеспечат
обещать: обещает
обладать: обладает
область: областью область области
обнаружить: обнаружила
обобщенные: Обобщённые
обработка: Обработка обработки
образец: образцом
обстоятельство: обстоятельства
общий: Общие общим
объединение: объединения
объект: объектов
объектный: объектно
обычный: обычными
один: одна
однако: Однако
одновременно: одновременно
одновременный: одновременного
однопоточный: однопоточного
ожидаться: ожидается
окружение: окружение
он: ним
оператор: Операторы
определение: Определение
определять: определяет
опровержимость: Опровержимость
организация: Организация
ориентировать: ориентированного ориентированных
основный: основных
отдельный: отдельные
отказ: отказе
отклонить: отклонён
очистка: очистке очистка
ошибка: ошибок ошибки ошибках ошибкам ошибками ошибка ошибкой
пакет: пакетов Пакеты
память: памяти
параллелизм: параллелизм параллелизма
параллелизме: параллелизме
параллельный: параллельного параллельное параллельные параллельный
первоначально: Первоначально
перевод: Переводы
передавать: передают
передача: передачи передаче
переменный: Переменные переменными
пересылка: Пересылка
перечисление: Перечисления
писать: писать
поведение: поведения
подверженный: подверженным
поддержка: Поддержка
подмножество: подмножества
подробнее: Подробнее
подсчет: подсчётом
подходить: подходит
пожалуйста: пожалуйста
позволять: позволяет
полезный: Полезные
получение: Получение получением
пользовательский: пользовательских
помогать: помогающих
помощь: помощью
понимание: Понимание
понятие: понятие
попытка: попытки
последовательность: последовательности
поток: потока поток потоков потоками потоки
поэтому: Поэтому
превращение: Превращение
предисловие: Предисловие
предлагать: предлагают предлагает
предоставлять: предоставляемых
предотвращение: предотвращение
преимущество: преимущества
привести: привести
привет: Привет
приложение: Приложения
пример: Пример
примечание: Примечание
проблема: проблем проблемы проблемами
проверка: проверку
программа: программы
программирование: программирования Программирование программированием
продвинуть: Продвинутые
проект: проектами Проект проекта
проектирование: проектирования
производительность: производительности производительностью
простота: простоты
профиль: профилей
процессор: процессоров
публикация: Публикация
путь: Пути путей
работа: Работа работы
рабочий: Рабочие рабочем
раз: раз
развертывание: развёртывания
разделять: разделяемого
различный: различными
разный: разных разные
разработка: Разработка разработки
разумный: разумной
рассмотреть: рассмотрим
расти: растущими
расширение: Расширение
расширить: Расширенные
расширять: Расширяемый расширяют
реализация: Реализация
редакция: Редакции
результат: результате
реорганизоваться: реорганизуется
рефакторинг: Рефакторинг
решать: решать
решение: решения решений решение
свой: своё свой
связать: связанных связанными
сервер: сервера сервер сервере
символ: символы
синтаксис: Синтаксис
система: системы система
ситуация: ситуации
скрыть: скрытых
слово: слова
сложный: сложным
совместно: совместно
совместный: совместного
содержать: содержит
создаваться: создаётся
создание: создание
создать: создать
сообщение: сообщений сообщения
соответствовать: соответствовать
сопоставление: сопоставление
состояние: состоянием состояния
список: списков
способ: способов способом
сравнение: Сравнение сравнению
среда: среды
срез: среза
срок: сроков
ссылка: Ссылки ссылок ссылками
ссылочные: Ссылочные
стандартный: стандартной
становиться: становятся
стратегия: стратегией
страх: страха
строка: строками строки
структура: структур структуры
считать: считала
также: также
такой: такое
текст: текста
тема: темы
термин: термин
тест: тестов тесты
тестирование: тестирование
тип: Типы Тип типов
типаж: типажи
тот: того
точный: точные точный
тратить: тратить
требование: требований
трейт: трейта трейтов трейт
трейты: трейты
указание: указания
указатель: указатели указателями указатель
улучшение: улучшения Улучшение
умный: Умные умными умный
управление: управления Управление
управлять: Управляющие управлять
уровень: уровня
условие: условиях
установка: Установка
устранимые: Устранимые
утечка: утечке
файл: файла файлов
финальный: Финальный
фрагмент: фрагментов фрагменту
функциональность: функциональности функциональностью
функциональный: Функциональные
функция: Функции
характеристика: характеристики
хороший: наилучшей
хранение: Хранение
цель: целей
цикл: циклы
часть: части
чтение: Чтение
что: чего Что
шаблон: шаблона Шаблоны шаблон
экземпляр: экземпляров
элегантный: элегантной
элемент: элемент элементов
это: это
этот: этих этот эта этой
эффективный: эффективное
являться: являются является
язык: Язык языка языков языки
ясный: ясных
