аварийный: аварийно
автоматический: автоматических
аннотация: аннотацию аннотация
анонимный: анонимные
аргумент: аргументов аргумента
безбоязненный: Безбоязненный
безопасный: безопасен
библиотека: библиотеки библиотекой
билд: билдов
бинарный: бинарных
более: более
больший: большей
большой: большое
быть: будет будете Есть было быть будь будут был
важный: важный
валидация: Валидация
вариант: варианты
ваш: вашими ваша ваш
введение: Введение
ввести: введёт ввести
ввод: вводом
вводить: вводящего
веб: веб
вектор: векторами векторах вектор Векторы вектора векторе вектору векторов
вести: вести
весь: Все всего всё
видимость: видимости
владение: владения владение
вместе: вместе
вместо: вместо
внезапный: внезапный
внимание: внимание
вносить: вносить
внутренний: внутренняя
возвращать: возвращаемых возвращает
возможность: возможности возможностей возможность
возможный: возможные
возникать: возникает
время: время времени
вспомните: Вспомните
вставить: вставить
вставлять: вставляем
вы: вы вами вам вас
выбрать: выбрать
вывод: выводом вывод вывода
выводимые: Выводимые
выводить: выводит
выглядеть: выглядеть
выделение: выделения
вызвать: вызовет вызовут
вызывать: вызываем
выполнение: выполнением Выполнение выполнения выполнении
выпуск: выпуска
выражение: выражением
высвобождать: высвобождает
выходить: выходит
гарантировать: гарантировать гарантирует
где: где
глава: Главе Главы
гласить: гласит
давать: давайте
далее: Далее
данные: Данных данные
данный: Данная данный
дать: дать
два: два
действие: действия
действительный: действительная действительными действителен
дерево: дереве
деталь: деталей
диапазон: диапазона
добавить: добавили добавить добавит
добавление: добавления добавление
документация: документацией
должный: должен должна должны
дополнение: дополнение
дополнительный: Дополнительные
допускать: допускающих
допустимый: допустимое
достаточный: достаточного
доступ: доступа доступ
друг: друг другом
другой: другим другие
дружелюбный: дружелюбным
единый: единой
ее: её
жизнь: жизни
заботиться: заботиться
завершение: завершение
завершить: завершила
загадка: загадки
задать: заданные
заимствование: заимствование заимствований заимствования
заключаться: заключается
закодировать: закодированного
замыкание: замыкания
запись: Запись
запускать: запускаем
затем: затем
захватывать: захватывают
здесь: здесь
знать: знает знайте знать знаете
значение: значений значениями значения значение значению
игра: игры
известный: известный
изменение: Изменение изменениях изменения
изменить: изменить
изменяемость: изменяемость
изменяемый: изменяемой изменяемых изменяемые изменяемого изменяемым изменяемая изменяемый
изменять: изменять
иметь: имеют иметь
индекс: индекса индексу индекс индексом индексов
индексация: индексации
индексироваться: индексируются
иногда: иногда
инструмент: инструменты
использование: Использование использованием использования
использовать: использующей использовать используем
использоваться: использоваться используются
исходить: исходить
исчерпывающий: исчерпывающий
итератор: итераторы итераторов
итерирование: итерирования Итерирование
итерировать: итерируем итерировать
каждый: каждого каждому каждый
какой: какие
качество: качестве
ключ: ключей
ключевой: ключевого Ключевые
книга: книги
когда: Когда
код: кода код кодом
коллекция: коллекции
команда: команд
командный: командной
комментарий: Комментарии
компилятор: компилятора
компиляция: Компиляция компиляции
конец: конец конце
конечный: конечном
конкретный: конкретного
конструкция: конструкции Конструкция
конфиденциальность: конфиденциальностью
концепция: концепции
копирование: копирования
корзина: корзине
который: которые который которой которое которую которого
крейт: крейтов крейты крейта
куча: куче
лаконичный: Лаконичный
легкость: лёгкостью
листинг: листинге Листинг листингах
логика: логику
любой: любой любые
макрос: Макросы макрос
место: места
метод: метода метод методу методов
мир: Мир
многопоточный: многопоточного многопоточный
множество: множества множестве
модификация: модификацию
модуль: модулей
модульность: модульности
можно: можно
момент: момент
мочь: могут может можем можете могли
мы: мы нам нас
мягкий: Мягкое
набор: набор
надо: надо
наиболее: наиболее
наличие: наличия
написание: Написание
например: например
настройка: Настройка
находиться: находится
начальный: начальными начальные
начать: начать
начинать: начиная
наш: нашего
небезопасный: Небезопасный
неизменяемый: неизменяемую неизменяемый
неизменяемых: неизменяемых
некоторый: некоторый некоторые
несколько: несколько
несуществующий: несуществующий
нет: нет
неудобно: неудобно
неустранимый: Неустранимые
никакой: никаких
новый: нового новый новой новое
нормальный: нормальных
нужный: нужно нужна нужен
нуль: нуля
оба: оба
обеспечение: обеспечения
обеспечивать: обеспечивает
область: областью область области
обобщенные: Обобщённые
обобщенный: обобщённых
обработать: обработаны
обработка: Обработка обработки
образец: образцом
обратите: Обратите
обстоятельство: обстоятельствах
обсудить: обсудили
обсуждаться: обсуждалось
общий: Общие общим
объединение: объединения
объект: объектов объект
объектный: объектно
обычный: обычными
обязательно: обязательно
один: одного один одной одному одним одном
одинаковый: одинакового
одновременный: одновременную
однопоточный: однопоточного
ознакомьтесь: ознакомьтесь
означать: означает
окружение: окружение
он: нему он ему его
они: Их
оператор: Операторы оператор операторе оператора
операция: операций
опечатка: опечатки
описать: описанные
определение: Определение
определенно: определённо
определенный: определённых
определить: определить определены
опровержимость: Опровержимость
организация: Организация
ориентировать: ориентированного ориентированных
освободить: освобождённую
особенность: особенности
оставаться: остаются
очередь: очереди
очистка: очистке очистка
ошибка: ошибок ошибки ошибках ошибке ошибка ошибку
пакет: пакетов Пакеты
память: памяти память
паника: панику паники
пара: пару
параллелизм: параллелизм
параллельный: параллельного
первый: Первым первая первый
перебор: Перебор
перевод: Переводы
передаваться: передаётся
передать: переданный
передача: передачи
перейти: перейдём
переменный: Переменные переменными переменной
пересылка: Пересылка
перечисление: Перечисления перечислений перечисление
печать: Печать
писать: писать
плавать: плавающей
поведение: поведения поведение
поговорить: поговорим
подобный: подобную
подробнее: Подробнее
подсчет: подсчётом
подход: подход
позволять: позволяют позволял
поздний: позже
пока: пока
показать: показано показанный показаны покажем
покупка: покупок
полезный: Полезные полезных
получать: получаем
получение: Получение получения
получить: получить получит получили
пользователь: пользователь пользователю пользователя
пользовательский: пользовательских
помещать: помещаем
помощь: помощью помощи
понимание: Понимание
попадание: попадание
попробовать: попробуем
попытаться: попытаетесь попытались
попытка: Попытка попытке
поскольку: Поскольку
последний: последний
последовательность: последовательности
посмотреть: посмотрим
поток: потока поток потоков потоками
потому: потому
потребовать: потребовать
потребоваться: потребуется
почему: Почему
поэтому: поэтому
правило: правил правило Правила
превращение: Превращение
предел: пределами
предисловие: Предисловие
предоставлять: предоставляемый предоставляет
предотвращать: предотвращают предотвращает
представление: представления
прежде: прежде
привести: привести приведёт
привет: Привет
прийтись: придётся
приложение: Приложения
применяться: применяется
пример: Пример примерах примера
примечание: Примечание
причина: причине Причина
проверить: проверить
проверка: проверки
программа: программы программа программ
программирование: программирования Программирование
продвинуть: Продвинутые
проект: проектами Проект проекта
проектирование: проектирования
производительность: производительности
происходить: происходит
пространство: пространство
профиль: профилей
публикация: Публикация
пустой: пустой пустого
путь: Пути путей
пытаться: пытаемся
пять: пяти пять
работа: Работа работы работу
работать: работать работают
рабочий: Рабочие
раз: раз
раздел: разделе
разделять: разделяемого
различный: различных
разместить: разместить
размещать: размещают
разный: разных разные
разобрать: разберём
разработка: Разработка разработки
разрешить: разрешены
разыменование: разыменования
распространить: распространённых
рассмотреть: рассмотрим
расти: растущими
расширение: Расширение
расширить: Расширенные
расширять: Расширяемый
реализация: Реализация реализации
реализовать: реализованы
редакция: Редакции
рефакторинг: Рефакторинг
сам: самого сам
сбой: сбой
сведение: сведения
свой: своё свою
связать: связанных связанными
сделать: сделать
себя: себя
сервер: сервера сервер
символ: символы
синтаксис: Синтаксис синтаксиса
ситуация: ситуацию
скобка: скобках
сколько: сколько
следование: Следование
следующий: следующих следующему
слишком: слишком
слово: слова
случай: случае случаи
случайно: случайно
смотрите: смотрите
собираться: собираемся
соблюдение: соблюдение
собственный: собственными
содержать: содержащий содержащего содержащем содержат содержать содержит
содержаться: содержащийся
содержимое: содержимое
создавать: создаём создавать
создаваться: создаётся
создание: создание
создать: создать создаст
сообщение: сообщений
сообщить: сообщили сообщить
соответствовать: соответствовать
сопоставление: сопоставление
сослаться: сослаться
состояние: состоянием
сохранять: сохраняемых
список: списков список
способ: способа способов
сработать: сработает
сравнение: Сравнение
среда: среды
средство: средство
срез: среза
срок: сроков
ссылаться: ссылается
ссылка: Ссылки ссылок ссылками ссылку ссылка ссылкам ссылке
ссылочные: Ссылочные
стандартный: стандартной
старый: старых
столбцы: столбцы
строка: строками строки строк строка
строковый: строковые
структура: структур структуры структуре структурам
существовать: существующих существует
счастие: счастью
счет: счёте
считаться: считаться
таблица: таблице
так: так
также: также
такой: такое Такой такую
там: там
текст: текста
текстовый: текстовых
текущий: текущем
тело: телах
теперь: Теперь
тест: тестов тесты
тестирование: тестирование
техника: техника
тип: Типы Тип типов типом типа типами типу
типаж: типажи типаж
товар: товаров
тогда: Тогда
тот: том то той того тем
точка: точкой
точно: точно
трейт: трейта трейтов трейт
трейты: трейты
третий: третьего
угловой: угловых
удаление: Удаление
удалить: удалить
удалять: удаляет
удаляться: удаляется
удобный: удобно
удобство: удобства
узнать: узнать
указание: указания
указатель: указатели указателями указатель указателю
указать: указать указали указанному
указывать: указывать
указывая: Указывая
улучшение: улучшения Улучшение
умный: Умные умными умный
умолчание: умолчанию
упоминаться: упоминалось
управление: управления Управление
управлять: Управляющие
установка: Установка
устранимые: Устранимые
утечка: утечке
файл: файла файлов
финальный: Финальный
функциональность: функциональности
функциональный: Функциональные
функция: Функции функцию функциями
характеристика: характеристики
хороший: лучше
хотеть: хотим хотите
хранение: Хранение хранения
хранить: хранить храним
храниться: хранящееся хранится
хранящей: хранящей
целочисленный: целочисленных
целый: целые
цена: цен
цикл: циклы цикл цикла цикле
частый: Чаще
человек: человека
четко: чётко
число: числа число
числовой: Числовым
чтение: Чтение
что: чего Что чём
чтобы: Чтобы
шаблон: шаблона Шаблоны шаблон
шанс: шанс
экземпляр: экземпляров
электронный: электронной
элемент: элемент элементов элементы элементу элемента элементам элементами
это: Это этому
этот: этот этой этими эта этого этом
являться: является
язык: Язык языка языков
ясность: ясности
