автоматически: автоматически
автоматический: автоматических
автор: авторов
активно: активно
активный: активной
анонимный: анонимные
аргумент: аргументов
аспект: аспектом
ассоциированный: ассоциированные
безболезненный: безболезненным
безбоязненный: Безбоязненный
бета: Бета
библиотека: библиотеки
билд: билдов
бинарный: бинарных
более: более
больший: большую
большинство: Большинство
бояться: бояться
быстрый: быструю
быть: был было быть есть была будет были будут
важный: важные
валидация: Валидация
ваш: Вашего вашей вашем
введение: Введение
ввод: вводом
веб: веб
вектор: векторами
версия: версию версий версией версии версия
весь: Все вся
ветвь: ветвь
ветка: ветке ветку Ветка ветки
вещь: вещь
видеть: видите
видимость: видимости
включать: включает
включить: включены
владение: владения владение
влиять: влияет
вместо: вместо
внутренний: внутренняя
внутри: внутри
возможно: возможно
возможность: возможности возможностей возможностями возможностях возможность
волноваться: волноваться
вперед: вперёд
вполне: вполне
время: время временем времени
всегда: всегда
вы: Вас Вы
вывод: выводом вывода
выводимые: Выводимые
выглядеть: выглядят
вызывать: вызываете
выполнение: выполнением Выполнение выполнения
выполнить: выполните
выпуск: выпуска Выпуски выпуск выпуском выпуске
выпускаться: выпускается
выпустить: выпущена выпустить
где: где
глобальный: глобальном
год: года
готовый: готова
давать: Давайте
давление: давление
данные: Данных данные
дата: дату дате
дать: даст
два: два
двигать: двигать
действие: действия
декабрь: декабре
делать: делает
день: день днём
дерево: дереве
дефект: дефектов дефекты
дизайн: дизайн
добавить: добавлена
добавление: добавления
добавлять: добавлять
документация: документация
должный: должны должно должна
дополнение: Дополнение
допускать: допускающих
другой: другими другие другое
его: Его
ехать: едет
еще: ещё
желать: желающими
жизнь: жизни
заботиться: заботиться заботитесь
забыть: забыли
завершение: завершение
зависимость: зависимости
загадка: загадки
задача: задача
заимствование: заимствование
закодировать: закодированного
замыкание: замыкания
запись: Запись
запрос: запроса
затем: затем
захватывать: захватывают
захотеть: захотите
знать: знаете
значение: значений значениями значения
игра: игры
идти: идёт идти
изменение: изменение
изменить: изменить
изменяемость: изменяемость
иметь: имеем
инструмент: инструменты инструментов
интернет: интернете
информация: информацию
инфраструктура: инфраструктура
использование: Использование
использовать: использующей использована используют использовать используемой использует используете использующие
использоваться: использоваться используется
исправить: исправлена исправлен
исправление: Исправление
исходный: исходном
итак: Итак
итератор: итераторы итераторов
итог: итоге
каждый: Каждое Каждую Каждый Каждые каждой
какой: какая
канал: Каналы канала канал каналами
каталог: каталоге
ключ: ключей
ключевой: ключевого Ключевые ключевой
книга: книги книга
когда: когда
код: кода код коде
коллекция: коллекции
команда: команд команда команду команды командой
командный: командной
комментарий: Комментарии комментариев
коммит: коммиты
компилятор: компилятора
компиляция: компиляции
компонент: компоненты
компьютер: компьютером
конечный: конечном
конкретный: конкретном
конструкция: конструкции Конструкция
конфиденциальность: конфиденциальностью
концепция: концепции
который: которые которая которое который
крейт: крейтов крейты крейта
кто: кто
куча: куче
лаконичный: Лаконичный
легкий: легко лёгким
локальный: локальном
любой: Любой
макрос: Макросы
меньше: меньше
меняться: менялось меняться
мера: мере
место: места
метод: метода
мир: Мир
многий: Многие
много: много
многое: многое
многопоточный: многопоточного многопоточный
множество: множество множества
модель: модели модель
модуль: модулей
модульность: модульности
момент: момент
мочь: могут может можем можете
мы: Мы
мягкий: Мягкое
набор: набор
надо: надо
называть: называемую
называться: называется
найти: найдена найти
написание: Написание
написать: написана написать
направляться: направляется
настройка: Настройка
наступать: наступает
находиться: находится находящейся находитесь
начать: начать
наш: нашего Нашим наш нашей наши
небезопасный: Небезопасный
невозможный: невозможно
неделя: недель
нее: неё
некоторый: некоторые некоторое
несомненно: несомненно
нестабильный: Нестабильные Нестабильных
неустранимый: Неустранимые
никогда: никогда
новый: новую новые новых новая новой новый
нога: ногу
номер: номера
ночной: Ночной ночная ночную ночные
ночь: ночь
нужный: нужно
обеспечение: обеспечения
область: областью область области
обнаружить: обнаружить
обновление: обновление
обобщенные: Обобщённые
обработка: Обработка обработки
образец: образцом
обратный: обратной
обсудить: обсудят
обсуждать: обсуждали
обсуждаться: обсуждаются
общий: Общие общим
объединение: объединения
объект: объектов
объектный: объектно
обычный: обычными
ограничение: ограничение
один: одну одного один
однопоточный: однопоточного
ожидаться: ожидалось
окружение: окружение
он: ему он
она: она её
они: их они
оператор: Операторы
опора: опорой
определение: Определение определения
определенный: определённый
опробовать: опробовать
опровержимость: Опровержимость
организация: Организация
ориентировать: ориентированного ориентированных
ответвление: ответвления
ответвляться: ответвляется
отклонить: отклонить
открываться: открывается
отличаться: отличаться
относительно: относительно
отполировать: отполирована
отправляться: отправляется
очень: очень
очистка: очистке очистка
ошибка: ошибок ошибки ошибках
пакет: пакетов Пакеты
память: памяти
параллелизм: параллелизм
параллельный: параллельного
перевод: Переводы
передача: передачи
передовой: передовых
перейти: перейти
переменный: Переменные переменными
пересылка: Пересылка
переход: перехода
перечисление: Перечисления
писать: писать пишет
поведение: поведения
подготовка: подготовки
подгруппа: подгрупп
подробнее: Подробнее
подсчет: подсчётом
поезд: поезде поездов поезда поезд
поездка: поездка
позволять: позволяет
поздний: позднее
покидать: покидает
полезный: Полезные
полный: полный
поломка: Поломки
получение: Получение
пользователь: пользователи пользователь пользователей
пользовательский: пользовательских
помогать: помогает
помощь: помощью помощи
понимание: Понимание
попадать: попадает
попасть: попала попасть
попробовать: попробовать
последовательность: последовательности
последовательный: последовательного
посмотреть: посмотреть
постоянно: постоянно
поток: потока поток потоков потоками
потому: потому
поэтому: поэтому
практика: практике
превращение: Превращение
предисловие: Предисловие
предложение: предложение предложения
предложить: предложил
предположить: предположим
прибывать: прибывает
привести: привести Приведём
привет: Привет
приложение: Приложения
пример: Пример
приниматься: принимается
принцип: принцип принципу
принять: принять принята
приходить: приходит
проблема: проблемы
программа: программы
программирование: программирования Программирование
программный: программными программного
продвинуть: Продвинутые
продолжать: продолжают
продукт: продукта продуктами
проект: проектами Проект проекта проекте проектов
проектирование: проектирования
производительность: производительности
произойти: произойдёт
происходить: происходит
пройти: прошло пройти
протестировать: протестировать
профиль: профилей
процесс: процесс процессу процессе
прочный: прочным
публикация: Публикация
путь: Пути путей
работа: Работа работы работу
работать: работает работать
рабочий: Рабочие
раз: раз
раздел: разделе
разделять: разделяемого
различный: различными
разный: разных
разрабатывать: разрабатываемые
разработка: Разработка разработки разработке
разработчик: разработчика разработчиков разработчикам разработчики
расписание: расписания
рассказывать: рассказывает
рассматриваться: рассматриваются
расти: растущими
расширение: Расширение
расширить: Расширенные
расширять: Расширяемый
реализация: Реализация
реализовать: реализовать реализующий
реалистичность: реалистичность
регрессия: регрессия
редакция: Редакции
редко: редко
релиз: релиза релиз
репозиторий: репозитория репозитории
рефакторинг: Рефакторинг
решение: решением решение
решить: решат
роль: роль
руководить: руководящий
сайт: сайте
сборка: сборки
свой: своё
связать: связанных связанными
сервер: сервера сервер
символ: символы
синтаксис: Синтаксис
система: системе
скоро: скоро
скорость: скорость
следить: следить
следовать: следуют следует
следующий: следующей следующая следующего следующий следующую
слово: слова
сломаться: сломается
случай: случае
случаться: случаются
смочь: смогут
снизить: снизить
снова: снова
собственный: собственные
совершаться: совершается
совместимость: совместимости
согласие: согласию
содержать: содержит
создаваться: создаётся создаются
создание: создание
сообщение: сообщений
сообщить: сообщить
соответствовать: соответствовать
соответствующий: Соответствующая
сопоставление: сопоставление
состояние: состоянием
состоять: состоит
состояться: состоялся
список: списков список
сравнение: Сравнение
среда: среды
срез: среза
срок: сроков
ссылка: Ссылки ссылок ссылками
ссылочные: Ссылочные
стабилизация: стабилизацией
стабильность: Стабильность стабильности
стабильный: стабильную Стабильный стабильной стабильных стабильные стабильная
стагнация: стагнации
станция: станцию
строка: строками строки
структура: структур структуры структурой
существовать: существуют
считаться: считается
так: так
также: также
такой: такое такой
текст: текста
тематический: тематических
теперь: Теперь
тест: тестов тесты
тестирование: тестирование
тестировать: тестируют
техника: технику
тип: Типы Тип типов
типаж: типажи
тот: то Ту те того тем
трейт: трейта трейтов трейт
трейты: трейты
три: три
убедиться: убедиться
убираться: убирается
уверенный: уверенными
увидеть: увидеть
удобный: удобно
узнавать: узнаете
указание: указания
указатель: указатели указателями указатель
указать: указать
улучшение: улучшения Улучшение
улучшить: улучшить
умный: Умные умными умный
умолчание: умолчанию
управление: управления Управление
управлять: Управляющие
ура: Ура
уровень: уровне
устанавливаться: устанавливается
установить: установленные установить
установка: Установка установки
устранимые: Устранимые
утечка: утечке
файл: файла файлов
финальный: Финальный
флаг: флаги флагом флаг флага
фундамент: фундаментом
функционал: функционала
функциональность: функциональности функциональность
функциональный: Функциональные
функция: Функции функция функций функциях
характеристика: характеристики
хороший: Хорошим
хорошо: Хорошо
хотеть: хотим хотят хотите
хранение: Хранение
цикл: циклы
час: часы
часть: частью часть
человек: Человек
через: Через
читать: читает
член: члены
чтение: Чтение
что: чего Что
шаблон: шаблона Шаблоны шаблон
шесть: шесть
экземпляр: экземпляров
экспериментальный: экспериментальные
экспериментировать: экспериментировать
элемент: элемент элементов
это: Это этом этого
этот: эти этому этой Этот Эта этих эту
являться: является
язык: Язык языка языков
