аналогия: аналогии
аргумент: аргумент
байт: байтов байты байта байт байтам
байтовый: байтовым
библиотека: библиотекой библиотеке библиотеки библиотека
близкий: близкая
бог: Боже
более: более
больший: большего большую
большой: больше
буква: букву букв буквы буквами
быть: есть будет быть было будут был
валидный: валидные
вариант: вариант варианты
ваш: вашей
вектор: вектора вектор векторе
вернуть: вернул
версия: Версия
весь: все всего всех
вещь: вещей вещь
вид: виде виду
видеть: видим видеть
владелец: владельцем
владение: владение
владеть: владеющим владеть
внимание: внимание
внутренний: Внутреннее
возврат: возврат
возвращать: возвращает возвращаемый
возвращение: Возвращение
возможность: возможностями возможностей
возможный: возможных
вопрос: вопрос
время: время
всегда: всегда
вставка: вставке
встроить: встроен
второй: вторую второй вторых
входной: входным
вы: вы вам вас
выбор: выбор
выбрать: выбрать
вывести: выведет
вывод: вывода
выглядеть: выглядит выглядеть
выделять: выделяет
вызов: вызове вызов вызова
вызывать: вызываемого вызываем вызывающего
вызываться: вызывается
выполнение: выполнения
выполнить: выполнить
выражение: выражения
выявление: выявлению
гарантировать: гарантировать
гарантия: гарантиями
глава: главе
говорить: говорили говорят говорит
графема: графем
громоздкий: громоздким
давать: даёт Давайте
данные: данных данные
данный: данном данный данная
два: два двух две
двоичный: двоичном
действительно: действительно
действительный: действительной действителен действительному действительным действительных
делать: делают делать делая
дело: делом деле
демонстрация: демонстрации
диакритики: диакритики
диапазон: диапазона диапазоны
длина: длиной длина
добавить: добавит добавить
добавление: Добавление добавления
добавлять: добавляет добавляющий
документация: документацией
должный: должно должен должны
дополнительный: дополнительными
допустимый: допустимые допустимой допустимым
доступ: Доступ доступа
доступный: доступны доступный доступен доступные
другой: других другой Другими
единственный: единственный
ее: её
еще: Ещё
желательный: желательно
забирать: забирает
зависеть: зависит
заглавный: заглавной
загрузить: загрузить
заимствовать: заимствованном
заключаться: заключается
заключить: заключённые
закодировать: закодированного закодированных
замена: замены
заменять: заменяющими
занимать: занимает
заниматься: занимаются
запаниковать: запаниковал
запомните: Запомните
заранее: заранее
застревать: застревают
затем: затем
зд: Зд
здесь: Здесь
здравствуйте: Здравствуйте
значение: значения значений значение значениями значению значением
значительно: значительно
значить: значит
зрение: зрения
идея: идеей
избыточный: избыточными
извлечение: Извлечение
изменяемый: изменяемым
иметь: имеют имеет
импонировать: импонирует
имя: именем
индекс: индексу индекса индекс индексы
индексация: индексации индексацию
индексирование: индексирование индексирования
индексировать: индексировать
инструкция: инструкция
интенсивно: интенсивно
интерпретация: интерпретации интерпретацию
интерпретировать: интерпретируют
интерпретироваться: интерпретируются
использование: Использование использовании использованием
использовать: используемый используем использовать использует используя использовали
использоваться: используются используется
используйте: используйте
исходный: исходное
итерация: итерацию
итог: итоге итог
каждый: каждого Каждая каждое каждой каждый каждому
каков: какова
какой: какими каким каком каких
касаться: касающийся
качество: качестве
кириллический: кириллической
кластер: кластеры кластером кластеров
ключ: ключ
когда: когда
код: Код коду кода кодом
кодирование: кодировании кодирования
кодировать: кодированные
кодировка: кодировке
кодируются: кодируются
количество: количества
коллекция: коллекций
комбинация: комбинации
комбинирование: комбинирования
компилировать: компилирует
компилироваться: компилируется
компилятор: компилятора компилятор
компромисс: компромисс
компьютер: компьютеры
конечный: конечном
конкретный: конкретными конкретным
контекст: контексте
копирование: копирование
копия: копию копий
корректный: корректным
который: которые которая которую который котором которой которое
латинский: латинские
легкий: легче
листинг: Листинге Листинг листинга
литерал: литералы литералов литерала
любой: любого любые
макрос: макрос макроса макросом
менее: менее
меняться: меняться
метод: методы метод метода методов
многий: многие многих
множество: множество множеством
можно: можно
мой: мой
момент: момент
мочь: может можем могут можете
мы: Мы нас нам
набор: набора
надо: надо
назвать: назвали назвал
назначить: назначить
наконец: Наконец
напечатать: напечатать напечатает
написать: написанное
например: Например
нарастить: нарастить
насчет: насчёт
начало: начала
начальный: начальные
начать: Начнём
начинаться: начинается
неверный: неверный
невозможный: невозможно
недействительный: недействительна недействительному
недопонимание: недопонимание
недопустимый: недопустимый
независимо: независимо
некоторый: некоторые некоторыми
немного: немного
необработанный: необработанных
необходимость: необходимости
необходимый: необходимых необходимую
непредвиденный: непредвиденного
несколько: несколько
новичок: Новички
новость: новость
новый: новых новый новой новую новое
нужный: нужно нужны нужен
оба: оба обе
обертка: обёртка
обеспечение: обеспечения
область: области
обнаружить: обнаружены
обновление: обновление
обобщенный: обобщённых обобщённый обобщённые
обозначение: обозначения
оболочка: оболочкой
обрабатывать: обрабатывать
обработка: обработку
образ: образом
обратите: Обратите
обращаться: обращались
обсудить: обсудим обсудить
обсуждать: обсуждать
объединение: объединения Объединение
объединить: объединить
объединять: объединять
объединяться: объединяются
обычно: обычно
обязательно: обязательно
ограничение: ограничениями
один: один одно одного
одинаково: одинаково
однако: Однако
ожидать: ожидали ожидает ожидают
ознакомьтесь: ознакомьтесь
означать: означает
он: него его он
она: ней
они: их они них
оно: оно
оператор: оператор оператора
операция: операциях операций операции операцией
определенный: определённым
определить: определим определён определить
осложняться: осложняется
основа: основе
основный: основном
особенность: особенностями особенностей
осторожность: осторожностью
ответ: ответ
ответить: ответить
отвечать: Отвечая
отдельный: отдельным отдельных
отличаться: отличается
отношение: отношение
очень: очень
ошибка: ошибок ошибку ошибке Ошибка ошибки
память: памяти
параметр: параметром параметра параметр параметров
первый: первых первой первый первую первые
перебор: перебора
переключиться: переключимся
переменный: переменную переменной переменная
переместить: перемещён
плохой: плохой
поведение: поведение поведением
поговорить: поговорим
подводя: Подводя
поддерживать: поддерживают
подождать: подождите
подразумевать: подразумеваем
подробно: подробно
подходящий: подходящим
позволять: позволяет
поздний: позже
поиск: поиска
показать: показана показано показан
показаться: показаться
показывать: показывает
полезный: Полезно полезной полезных
получение: получения
получить: получить получите получим
пользователь: пользователь Пользователи
помнить: помните
помочь: помочь
помощь: помощью помощи
понадобиться: понадобилось
понимание: понимания
понять: понять
попытаться: попытаетесь
попытка: Попытка
посвятить: посвящён
поскольку: Поскольку
последний: последней Последняя
посмотреть: посмотрим посмотреть
постоянный: постоянное
построить: построенных
потому: потому
почему: почему
поэтому: поэтому
появиться: появиться
правильно: правильно
правильный: правильную
превращать: превращает
предлагать: предлагает
предметный: предметной
предоставлять: предоставляемый предоставляющих предоставляет
предотвратить: предотвратить
предотвращать: предотвращает
представить: представлены представить
представление: представление
предусмотреть: предусмотрена
прежний: прежнему
приведение: приведение
привести: привести приведёт
приветствие: приветствий
прийти: пришли
применение: применения
пример: Примером примера
примерно: примерно
примечание: примечание
принимать: принимает
принудительно: принудительно
принудительный: принудительное
присоединение: Присоединение
присоединять: присоединяет
причина: причин Причина
программа: программы программе программ
программирование: программирования
программист: программисты программиста
продумать: продумать
производительность: производительность
произойти: произошло
происходить: происходит
пройтись: пройтись
просить: просит
простой: просты
процесс: процесса
пустой: пустой пустую
работать: работает работать
равный: равно равен
раздел: разделе раздел
различие: различием
различный: различные
размер: размере
разный: разных
разработка: разработки
ранее: Ранее
ранний: ранних
раскрывать: раскрывает
распространить: распространённой
рассмотрение: рассмотрения
рассмотреть: рассмотрим
расширять: расширяемым
реализация: реализация
реализовать: реализованы реализован реализует реализуют
результат: результате результатом результату
решить: решили
сам: самом само сами
самый: самая
сбой: сбою
свой: своим
связать: связанных связанные
сгенерированный: сгенерированный
сделать: сделать
себя: себе
сейчас: сейчас
сигнатура: сигнатуре сигнатура
сигнатуру: сигнатуру
символ: символ символа символов символам символом символы символами
синтаксис: синтаксис
ситуация: ситуации
скалярный: скалярное скалярному скалярные скалярных
складывать: складываем
склонность: склонность
сколько: сколько
скопировать: скопирует
скорый: скорее
следовательно: Следовательно
следующий: следующей следующим следующее
слово: словами слово словом
сложить: сложить
сложность: сложность
сложный: сложная сложной сложного сложным сложны сложные сложное
случай: случае
смотреть: смотря
смочь: сможем смогли
смысл: смысла
сначала: Сначала
содержать: содержать содержит
содержаться: содержится
содержимое: содержимое содержимому содержимого содержимым
создавать: создающая создаёт создают
создание: создание создания создании
соответствовать: соответствовал
составлять: составляющих
состоять: состоящем состоять состоит
сохранить: сохранят
специальный: специальные
способ: способов способом способа способы способ
сразу: сразу
срез: срез срезах срезами срезы среза срезов
срезом: срезом
ссылка: ссылками ссылку ссылки
стандартный: стандартной стандартная
становиться: становится
стать: стал
стиль: стиля
строка: строках строки строка строк строке строку строкой
строковый: строковый строковые строковым строковую строковых строкового
структура: структура
существовать: существующие существует
считать: считают
так: так
также: также
такой: таким таких такое такой такую
текст: текста текст
тема: тема
термин: термином
тип: типа тип типом типы типов типами типу
типаж: типаж
тоже: тоже
тот: тем тех того том то тому
точка: точки
точно: точно
транскрипция: транскрипции
требоваться: требуется
три: трёх три
трудный: трудно
увеличиваться: увеличиваться
увидеть: увидите
указание: указание
указать: указать
умолчание: умолчанию
упоминать: упоминали
устанавливать: устанавливает
файл: файле
фактически: фактически
фактор: факторы
фрагмент: фрагментами
функционал: функционал
функциональность: функциональности функциональность
функциональный: функциональных
функция: функции функция функцию
хинди: хинди
ход: ходе
хороший: Лучший Хорошая
хотеть: Хотя хотим хотел хотят
хотеться: хочется
хранение: Хранение
хранить: хранит хранят
храниться: хранятся хранится
цифра: цифры
часто: Часто
часть: частям частей
чей: чья
человек: люди человек
человеческий: человеческом
четвертый: четвёртый
четко: чётко
четыре: четырёх четыре
число: числу
числовой: числового
читаться: читается
чтение: чтение
что: Что
шестой: шестой
шесть: шесть
эквивалентный: эквивалентным
экземпляр: экземпляр экземпляра
экран: экран
элемент: элементу
этап: этапах
это: этого это
этот: Эти этом этот Эта этих этой эту
эффективный: эффективна
юникод: Юникоде
являться: являются является
ядро: ядре ядро
язык: языков языка языках языке языком языки
ясный: ясно
