автоматический: автоматических автоматического
алгоритм: алгоритмов
алфавитный: алфавитном
анонимный: анонимные
аргумент: аргументов
ассоциативный: ассоциативный
атака: атакам
базовый: базовый
безбоязненный: Безбоязненный
безопасность: безопасности
безопасный: безопасна безопасны
библиотека: библиотеки библиотеке библиотек
билд: билдов
бинарный: бинарных
более: более
больший: наибольшее
большой: большое
быстрый: быстрый
быть: будет быть будут были было есть
валидация: Валидация
вариант: вариантов вариантами варианта вариантом
ваш: вашего
введение: Введение
ввод: вводом
веб: веб
вектор: векторами векторах векторам векторы вектор векторов
вернуть: вернёт верните
весь: Все всех
видимость: видимости
владелец: владельцем
владение: владения владение владением владении
вместо: вместо
внимание: внимание
внутренний: внутренняя
возвращать: возвращает Возвращаемое возвращать
возможность: возможности возможностей
возможный: возможных
вопрос: вопросах
воспользоваться: воспользоваться
впервые: впервые
время: время времён времени
вспомнить: вспомните
вставить: вставлены вставим вставить вставит
вставка: вставка вставки
вставлять: вставляем вставляют вставлять
встретить: встретили
встречаться: встречается
встроить: встроенного
второй: второй
входной: входного
вхождение: вхождений
вы: вы Вам
вывод: выводом
выводимые: Выводимые
вызов: вызовом вызов
вызывать: вызывая вызывает
выполнение: выполнением Выполнение выполнения выполнении
выпуск: выпуска
выход: выхода
где: где
глава: главы Главе
гласный: гласную
говорить: говорит
готовый: готовы
давать: Давайте
данные: Данных данные данным
данный: Данная данном
два: двух двумя
дважды: дважды
действие: действия
действительный: действительными действительна
делать: делали
делаться: делается
дерево: дереве
деталь: деталях
добавить: добавить
добавление: добавления
добавлять: добавлять
добавляться: добавляется
документация: документации Документация
должный: должны должно
дополнительный: дополнительной
допускать: допускающих
допустимый: Допустим
достаточный: достаточное
доступ: Доступ
другой: Другим другом другой
еще: ещё
желтый: жёлтой жёлтая
жизнь: жизни
завершение: завершение
загадка: загадки
задание: задания
заимствование: заимствование заимствования
закодировать: закодированного
замена: Замена
заменить: заменить заменено
замыкание: замыкания
запись: Запись
затем: затем
захватывать: захватывают
звездочка: звёздочки
здесь: Здесь
значение: значениями значений значения значение значением
игнорировать: игнорируя игнорировать
игра: игры игре
идеальный: идеальное
идти: идёт
иза: Из
изменение: изменения
изменить: изменить изменит
изменяемость: изменяемость
изменяемый: Изменяемая
изменять: изменяемую
или: Или
иметь: имеют имеет иметь имел
иметься: имеется
имея: Имея
импорт: импорта
имя: имя имена
индекс: индекс
инструмент: инструменты
интерфейс: интерфейс
информация: информации
искать: искать
использование: Использование использования использованием
использовать: использующей используя используемой использовать Используем использует используемая
использоваться: использоваться
используйте: используйте
итератор: итераторы итераторов итератор
итерация: итерация
итог: Итоги
каждый: каждой каждый каждую каждого
какой: какого какое
карта: карта карты карте карт карту
качество: качестве
класс: класса
ключ: ключей ключи ключа ключ ключу ключом ключе
ключевой: ключевого Ключевые
книга: книги
когда: когда
код: кода код коде
кодировка: кодировкой
кодировку: кодировку
количество: количество количества
коллекция: коллекции коллекция коллекций
команда: команд команды команда командой
командный: командной
комментарий: Комментарии
компания: компании
компромисс: компромисс
конец: конец
конкретный: конкретном конкретный
конструирование: конструирования
конструкция: конструкции Конструкция
конфиденциальность: конфиденциальностью
концепция: концепции
копируются: копируются
который: которые которую который которой которое которая которых
крейт: крейтов крейты крейта
куча: куче
лаконичный: Лаконичный
латынь: латыни
листинг: листинге Листинг листинга
логика: логики
любой: любого
макрос: Макросы макроса
малый: меньшую
массив: массив
медиану: медиану
медленный: медленная
место: места
метод: метода Метод методы
мир: Мир
многопоточный: многопоточного многопоточный
множество: множестве множеством
мода: моду
модифицировать: модифицировать
модуль: модулей
модульность: модульности
можно: можно
момент: момент
мочь: могут может можете можем
мы: мы
мягкий: Мягкое
набор: набор
набрать: набрала
название: название названию
назначить: назначенное
называть: называемый
наименее: наименее
наименование: наименованиями
намного: намного
напечатать: напечатает напечатано
написание: Написание
например: например
настройка: Настройка
наступить: Наступило
находиться: находятся
начальный: Начальное
начать: начать
начинаться: начинающемуся
наш: нашего
небезопасный: Небезопасный
неверно: неверно
некоторый: некотором
необходимый: необходимо
несмотря: несмотря
нет: нет
неудача: неудачу
неустранимый: Неустранимые
новый: новой новым новое нового
ноль: ноль
нужный: нужно
обеспечение: обеспечения обеспечением
область: областью область области
обновление: Обновление
обобщенные: Обобщённые
обрабатывать: обрабатывать
обработка: Обработка обработки
образ: образом
образец: образцом
обратите: Обратите
обратиться: обратиться
обратный: обратное
обслуживание: обслуживании
обсуждение: обсуждения
общий: Общие общим общих
объединение: объединения
объединить: объединить
объект: объектов
объектный: объектно
объявление: объявлении
обычно: Обычно
обычный: обычными
обязательно: обязательно
один: одно один одну одного
одинаковый: одинаковый одинаковое
однопоточный: однопоточного
однородный: однородны
оказаться: окажется
окончание: окончание
окружение: окружение
он: ним его него
она: её неё она ней ей
они: их они
оно: оно
оператор: Операторы
операция: операции
описывать: описывает
определение: Определение
определенный: определённое
определить: определён
опровержимость: Опровержимость
организация: Организация
организовать: организует
ориентировать: ориентированного ориентированных
основа: основе
оставаться: оставаться
остальной: Остальной
отдел: отдела отделам
отказ: отказ
отслеживать: отслеживать отслеживаем
отсортированных: отсортированных
отсутствовать: отсутствует
очень: очень
очистка: очистке очистка
очко: очков очкам
ошибка: ошибок ошибки ошибках
пакет: пакетов Пакеты
память: памяти
пара: пары пару
параллелизм: параллелизм
параллельный: параллельного
параметр: параметра параметр
первый: первый Первая
перебирать: перебирать
перевод: Переводы
передача: передачи
перезаписать: перезаписано
перезапись: Перезапись
переменный: Переменные переменными переменной
переместить: перемещены
перемещаться: перемещается
пересылка: Пересылка
переходить: переходим
перечисление: Перечисления перечисление
печатать: печатать
печататься: печатаются
писать: писать писали
поведение: поведения
поговорить: поговорим
поддержка: поддержку
подключаться: подключается
подключение: подключения
подобный: Подобно
подробнее: Подробнее
подсчет: подсчётом Подсчёт
подсчитывать: подсчитывает
подход: подхода
позволить: позвольте
позволять: позволяющий
поиск: поиск
пока: пока
показать: показано показан
показывать: Показывает
полезный: Полезные полезны полезных полезна
полностью: полностью
получать: получать
получение: Получение получения
получить: получить
пользователь: пользователю
пользовательский: пользовательских
помните: Помните
помощь: помощью помощи
понимание: Понимание
пора: пор
поросячий: поросячьей
порядок: порядке
последний: Последняя
последовательность: последовательности
посмотреть: посмотрим
потерпеть: потерпеть
потихоньку: Потихоньку
поток: потока поток потоков потоками
потому: потому
поэтому: поэтому
правило: правилами
превращение: Превращение
предисловие: Предисловие
предоставить: предоставят
предоставлять: предоставляющих
предприниматься: предпринимаются
представлять: представляет
прежде: прежде
преобразуйте: Преобразуйте
привести: привести
привет: Привет
приложение: Приложения
пример: Пример
принимать: принимает
присвоить: присвоить
пробел: пробелам
проверить: проверить
проверка: проверки
проверять: проверяют
программа: программы программе программ программам
программирование: программирования Программирование
продвинуть: Продвинутые
проделать: проделать
проект: проектами Проект проекта
проектирование: проектирования
произвести: произвести
производительность: производительности производительность
произвольный: произвольном
происходить: происходит
противостоять: противостоять
профилирование: профилирования
профиль: профилей
публикация: Публикация
пустой: пустую
путь: Пути путей
работа: Работа работы
рабочий: Рабочие
раз: раз
раздел: разделе
разделить: разделённых
разделять: разделяемого
разный: разных разными разные
разработка: Разработка разработки
разыменование: разыменование
распространить: распространённым
рассмотреть: рассмотрим
расти: растущими
расширение: Расширение
расширить: Расширенные
расширять: Расширяемый
реализация: Реализация реализации
реализовать: реализована реализуют
реализовывать: реализовывать
реализующий: реализующий
редакция: Редакции
результат: результат
рекомендовать: Рекомендуем
рефакторинг: Рефакторинг
решение: решении
решить: решить
самостоятельный: самостоятельное
самый: самое самый
свой: своё свои свою
связать: связанными связанных связанное
сделать: сделать
секция: секции
сервер: сервера сервер
середина: середины
символ: символы
синий: синей Синяя
синтаксис: Синтаксис
сколько: сколько
скрываться: скрывается
следовать: следует
следующий: следующие
слово: слова слово словами слов
слову: слову
сложный: сложным
случай: случай случае
сначала: сначала
собственный: собственную
советовать: советуем
совсем: совсем
согласный: согласная
согласоваться: согласуется согласуются
содержать: содержит содержать
создаваться: создаётся
создание: создание
создать: Создать Создайте
сообщение: сообщений
соответствовать: соответствовать
соответствующий: соответствующее
сопоставление: сопоставление
сортировка: сортировки
состояние: состоянием
сотрудник: сотрудников
сохранить: сохранить
сохранять: сохраняем сохранять
специальный: специальный
список: списков список списка списке
сравнение: Сравнение
сразу: сразу
среда: среды
средний: среднее
срез: среза срезам
срок: сроков
ссылка: Ссылки ссылок ссылками ссылку ссылка
ссылочные: Ссылочные
стандартный: стандартной
становиться: становится
старый: старое старых старого
стать: станет
сторона: стороны
строка: строками строки строку строк
структура: структур структуры структура
существовать: существует существующее существовать
счет: счёт
счетчик: счётчики
таблица: таблиц
так: так
также: также
такой: такое такими такого таким таких
текст: текста тексте
текстовый: текстовый
теперь: Теперь
тест: тестов тесты
тестирование: тестирование
техника: техника
тип: Типы Тип типов типа
типаж: типажи типаж типажах
тоже: тоже
тот: то того тех тот том
трейт: трейта трейтов трейт
трейты: трейты
три: трёх
увеличивать: увеличиваем
увеличиваться: увеличиваться
увидеть: увидите
удаляться: удаляется
уже: уже
указание: указания
указатель: указатели указателями указатель
указать: указать
указывать: указывают
улучшение: улучшения Улучшение
умный: Умные умными умный
умолчание: умолчанию
управление: управления Управление
управлять: Управляющие
упражнение: упражнений
установка: Установка установки
устранимые: Устранимые
утверждение: утверждение
утечка: утечке
учебный: учебные
файл: файла файлов
финальный: Финальный
функционал: функционала
функциональность: функциональности
функциональный: Функциональные
функция: Функции функций функцией Функция функцию
характеристика: характеристики
хеш: хеш
хеширование: хеширования
хороший: лучшей
хотеть: хотите хотим
хотя: Хотя
хранение: Хранение
хранить: хранит хранят хранить хранимого
храниться: хранятся
целый: целых
цикл: циклы цикл цикла
часто: часто
человек: людей
число: чисел
чище: чище
чтение: Чтение
что: чего Что
шаблон: шаблона Шаблоны шаблон
экземпляр: экземпляров
элемент: элемент элементов элементы элемента
это: это этого
этот: этом этому Этот этих этим Эта эти
являться: является
язык: Язык языка языков
