абсолютный: абсолютный
автоматический: автоматического
аналогично: аналогично
аналогия: аналогии
библиотека: библиотеки библиотека библиотекой библиотеку библиотеке
бинарный: бинарного
более: более
больший: больших
быть: есть был будет было будут Будьте были
ваш: вашего ваш вашей
везде: везде
вероятно: вероятно
вертикальный: вертикального
веский: веской
весь: все всего
вид: виду
видеть: видите
видимость: видимости
включать: включает
включение: Включение включения
включить: включён включить
влияние: влияние
вложить: вложенных вложенные вложенного вложенный вложенном
внешний: внешний внешних внешние внешним
внимание: внимание
внутренний: внутренняя
внутри: внутри
вопрос: вопросом
время: время
второй: второй
вы: вы вами
выбирать: выбирали
выбор: выбор
выбрать: выбрали
вызвать: вызвать вызвали
вызов: вызова вызове
вызывать: вызывает вызывать вызывающие вызывающих
выполнять: выполняют
где: где
генерация: генерации Генерация
глава: Главы Главе
давать: даёт
данный: данный данного
два: два двух две
двоеточие: двоеточия
действие: действия
делать: делаем
длинный: длинных
добавить: добавили добавить
добавление: Добавление добавлением добавления
документация: документацию
должный: должны должен
дом: дома
дополнительный: дополнительной
допустимый: допустимым
достаточный: достаточно
доступность: доступность
доступный: доступное доступным доступными
дочерний: дочерний дочернем
другой: другие другой других другое другому другую другая другого
думать: думают думать
его: его
еще: ещё
зависимость: зависимости
загрузить: загрузить
задаться: задаться
задача: задачу
задний: задней
заменить: заменено
занимать: занимать
записывать: записывать
запрограммировать: запрограммировали
затем: затем
значительно: значительно
игра: игру
идиома: идиомой идиомы
идиоматическ: идиоматически
идиоматический: идиоматических идиоматическим идиоматический
идиоматичный: идиоматичными
изменение: изменения
изменять: изменять
иметь: имели имеют
импорт: импорта
имя: имя именем именами имени имён имена
иногда: иногда
инструкция: инструкции Инструкция инструкцию инструкций
информация: информации
исключение: Исключением
использование: использование использования использованием использовании
использовать: использовать используя использовали используем используемые
использоваться: использоваться используется использовался используются
их: их
каждый: каждый каждого
какой: какой какие
качество: качестве
клиент: клиенты
ключевой: ключевого ключевое
код: коде код коду кода кодом
количество: количество
компилироваться: компилироваться
компилятор: компилятора
конкретный: конкретной
конфликтовать: конфликтовать
корневой: корневой корневом корневого
короткий: короткое
который: которой которого которое который которые которых которым
крейт: крейта крейтом крейте
листинг: листинге Листинг листинги листинга
локально: локально
локальный: локальное
любой: любые любым любого любом
метод: метод
минимум: минимуму
много: много
множество: множества
модуль: модуль модуля модуле модулей модули
можно: можно
мочь: может можем могли
мы: мы нам
название: названия
называться: называется
найти: нашёл
написать: написать
напомнить: Напомним
например: Например
находиться: находится находятся
начинаться: начинающуюся начинающийся
наш: наш наша нашем нашего нашему
нее: неё
независимо: независимо
неидиоматический: неидиоматическим
необходимость: Необходимость
необходимый: необходимо необходимых
несколько: несколько нескольких
нет: нет
неудобный: неудобной
новый: новый новых новое новой
нужный: нужно
область: область области областях
образ: образом
обратите: Обратите
общедоступный: общедоступной общедоступного общедоступные
общий: общую Общей
объединение: объединении Объединение
объединить: объединить
объявление: объявление
один: один одну одной одного одни одном одна
одинаковый: одинаковыми одинаковым
означать: означает
он: он него
она: её
они: них им
оно: оно
оператор: Оператор оператора
определение: определения
определенный: определённых
определить: определён определена определено определённые определены
организовать: организована
осторожный: осторожны
отдельный: отдельной отдельных
открытый: открытые
отличаться: отличается отличаются
относительный: относительный
отношение: отношению
оттуда: оттуда
ошибка: Ошибка
пакет: пакетов пакет пакета пакеты пакету
первый: первый
передний: передней
переименование: переименования Переименование
переместить: переместить
перемещаться: перемещается
перечисление: перечислений перечисление
писать: писать
повторение: повторение
повторно: повторно
повторяться: повторяющейся
поговорить: поговорим
подключать: подключаем подключает
подключение: Подключение подключения подключении
подключенные: подключённые
подключить: подключили подключить подключён
позволить: позволить
позволять: позволяет
показать: показано показаны
показаться: показаться
показывать: показывает
полезный: полезен полезно
полный: полного полный
получение: получения
помощь: помощью помощи
понимание: понимание
понять: понять
посещать: посещающие
поскольку: Поскольку
поставляться: поставляется
потому: потому
почему: почему
поэтому: поэтому
появиться: появилось
правильный: правильным
предметный: предметной
предоставление: Предоставление
предупреждение: предупреждение
префикс: префиксом
приватный: приватным
привыкнуть: привыкли
применяться: применяется
пример: пример
приходиться: приходилось
причина: причины
проблема: проблему проблемы
проверяться: проверяются
программа: программе программах
программист: программисты программистов
продолжение: продолжения
проект: проекте проекта
пространство: пространства
процесс: процесс
прямо: прямо
псевдоним: псевдоним
путь: путей пути путь путём
работать: работающих
раз: раз
раздел: разделе
различать: различать
разный: разных
рассмотреть: рассмотрим
результат: результата
ресторан: рестораном ресторан ресторана
ресурс: ресурсе
решение: решение
решить: решить
реэкспорт: Реэкспорт реэкспортом
родительский: родительском родительского родительский родительских родительские
сам: само
сводить: сводя
свой: своей
сделать: сделать сделали
себя: собой себя
символический: символической
система: системе
скобка: скобки
следовать: следуют следует
слово: слова слово
случай: случай
случайный: случайного
смотреть: смотрите
смочь: смог
собственный: собственной
соглашение: соглашение
создавать: создаёт
создание: созданию Создание
создать: создать
сократить: сократить
сообщество: сообщества
сослаться: сослаться
список: списка списков
способ: способ способом
ссылаться: ссылаться
ссылка: ссылки
стандартный: стандартной стандартная
становиться: становится
сторона: стороны
строка: строку строке строкой строка
структура: структур структуры структура структурой структуру
счастие: счастью
считаться: считаются
также: также
такой: таким таких
текущий: текущую
тело: тело
теперь: теперь
термин: терминах
тест: тесты
тестирование: тестировании
тип: типа типов типом
тот: того той том ту то те тех
трейт: трейт
угадывание: угадывания
удобный: удобного
указание: указания Указание
указать: указать указали
указывать: указывать указывает указывая
уменьшение: уменьшения
употребление: употребление
управлять: управляющие
упростить: упростить
уровень: уровне
усложнить: усложнить
файл: Файл файле
файловый: файловой
фигурный: фигурные
функция: функциям функции функция функцию
хорошо: хорошо
хотеть: хотели хотим
часто: часто
часть: части частях часть частей частью
человек: Люди
число: числа
читать: читать
член: Члены
что: что
шаблон: шаблона шаблоне
шаг: шаги
экспорт: Экспорт
экспортировать: экспортировало
элемент: элементов элемента элемент элементы
это: это этого этому этом
этот: этот этой эту эти этих Эта
являться: является
язык: языком
ясный: ясно
