автоматически: автоматически
автоматический: автоматических
аналогично: аналогично
аналогичный: аналогичным
анонимный: анонимные
аргумент: аргументов аргумента аргументом
безбоязненный: Безбоязненный
бесконечно: бесконечно
беспокоиться: беспокоиться
библиотека: библиотеки библиотекой библиотека
билд: билдов
бинарный: бинарных
более: более
больше: больше
больший: большая
большинство: большинстве
быть: есть будет будем был быть было были
важный: важно
валидация: Валидация
введение: Введение
ввести: ввели
ввод: вводом
веб: веб
вектор: векторами
вернуть: вернул
верный: верно
версия: версия
вести: ведёт
весь: Все всей всеми
взаимодействовать: взаимодействует
видимость: видимости
включить: включить
владение: владения владение
вместо: вместо
внимание: внимание
внутренний: внутренняя внутренние внутренним
внутри: внутри
возвращать: возвращает возвращал
возможно: возможно
возможность: возможности возможностей возможность
возможный: возможным
вопрос: вопрос
воспользоваться: воспользуемся
время: время
вспомним: вспомним
вставить: вставить
второй: второй втором
вы: вы вам вас
вывод: выводом
выводимые: Выводимые
вызвать: вызвать
вызов: вызовом вызовов вызовы вызов вызова
вызывать: вызывает вызывать вызываем
вызывая: вызывая
выполнение: выполнением Выполнение выполнения
выполнить: выполнил
выполнять: выполняет
выпуск: выпуска
гарантировать: гарантируют
где: где
глава: Главы главе
глобальный: глобального
говориться: говорится
давать: Давайте даёт
далее: Далее
данные: Данных данные
два: два
действие: действия действии
делать: делает делали
дерево: дереве
добавить: добавить добавленную добавлено
добавление: добавления
добавлять: добавлять
документация: документации
должный: должны должна
допускать: допускающих
допускаться: допускается
доступ: доступ
друг: друг другу
другой: другом другой
думать: думать
единственный: единственной
еще: ещё
жизнь: жизни
завершение: завершение
загадка: загадки
задействовать: задействованных
заимствование: заимствование заимствования
заимствовать: заимствует
заключаться: заключается
закодировать: закодированного
замена: замена
заменить: заменён
заменять: заменяет
замыкание: замыкания
запись: Запись
заполнить: заполним
затем: Затем
захватывать: захватывают
здесь: здесь
знать: знает
значение: значений значениями значения значение значению значении значением
игра: игры
идентичный: идентичны
изменить: изменить изменим
изменяемость: изменяемость изменяемостью
изменяемый: изменяемых изменяемую изменяемым изменяемая изменяемой
иметь: имеющая имеет
имя: именем
инструмент: инструменты
исключение: исключением
использование: Использование использования
использовать: использующей Используя использовать используем используемый использовали использует используете
использоваться: использоваться
итератор: итераторы итераторов
итог: итоге
каждый: каждый
качество: качестве
ключ: ключей
ключевой: ключевого Ключевые
книга: книги
когда: когда
код: кода код коде
количество: Количество
коллекция: коллекции
команда: команд
командный: командной
комментарий: Комментарии
компилироваться: компилироваться компилируется
компилятор: компилятор компилятору
компиляция: компиляции
конечный: конечном
конструкция: конструкции Конструкция
конфиденциальность: конфиденциальностью
концепция: концепции
кортеж: кортежа
кортежный: кортежной
который: которые который которое которому которая которую которой
крейт: крейтов крейты крейта
круглый: круглых
кулисами: кулисами
куча: куче
лаконичный: Лаконичный
листинг: листинге Листинг листингом листинга
любой: любыми любого
макрос: Макросы
менее: менее
место: места месте
метод: метода методов Метод методами
механизм: механизм
мир: Мир
многопоточный: многопоточного многопоточный
множество: множество
модуль: модулей
модульность: модульности
можно: можно
мочь: могут может можете можем мог
мы: мы нам нас
мягкий: Мягкое
накладный: накладных
наличие: наличия
написание: Написание
написать: написать
направлять: направляющую
например: Например
напрямую: напрямую
нарушить: нарушит
настройка: Настройка
находить: находит
начать: начать
наш: нашего наша наш
небезопасный: Небезопасный
независимо: независимо
неизменяемый: неизменяемых неизменяемой неизменяемые неизменяемую
некоторый: некоторого
немного: немного
необходимый: необходимо необходимый
неустранимый: Неустранимые
неявные: Неявные
никогда: никогда
новый: нового
нужный: нужно
обеспечение: обеспечения
область: областью область области
обобщенные: Обобщённые
обобщенный: обобщённый обобщённого
обрабатывать: обрабатывать
обработка: Обработка обработки
образ: образом
образец: образцом
обратите: Обратите
обратный: обратное
обращение: Обращение
обсуждаться: обсуждалось
общий: Общие общим
объединение: объединения
объект: объектов
объектный: объектно
объявить: объявленного
объявление: объявления
объявлять: объявляем
обычный: обычными обычная обычной
один: одна одним один одного одной
одинаково: одинаково
однако: Однако
однопоточный: однопоточного
окружение: окружение
он: он него
она: она её
они: они них их
оно: оно
оператор: Операторы оператора операторами оператор оператором
оперирующий: оперирующий
описать: описано
определение: Определение определению определении
определенный: определённой определённого определённым
определить: определить определим определили определён
определять: определяя определяем определяет
определяться: определяется
опровержимость: Опровержимость
организация: Организация
ориентировать: ориентированного ориентированных
основный: Основное
особенный: особенного
отличаться: отличается
очистка: очистке очистка
ошибка: ошибок ошибки ошибках ошибку
пакет: пакетов Пакеты
память: памяти
параллелизм: параллелизм
параллельный: параллельного
параметр: параметр параметра
первый: первому Первые первом
перевод: Переводы
передавать: передавать передаём
передать: переданное передали
передача: передачи
перейти: перейти
переменный: Переменные переменными Переменной
переместиться: переместилось
переопределение: переопределения
переписать: переписать
пересылка: Пересылка
переход: перехода
перечисление: Перечисления
писать: писать
пишущий: пишущим
поведение: поведения поведение
повторяться: повторяется
подключение: подключения
подобный: подобное Подобно
подробнее: Подробнее
подробно: подробно
подсчет: подсчётом
позволять: позволяет
пока: пока
показать: показано
показывать: показывает
полезный: Полезные
получать: получает получаем
получение: Получение
получить: получим получили получить
пользовательский: пользовательских пользовательский
помощь: помощью
понимание: Понимание
понимать: понимать
понять: понять
попробовать: попробуем
попытаться: попытаемся попытались
попытка: Попытка
поскольку: Поскольку
последний: последнем
последовательность: последовательности
посмотреть: посмотрим
поток: потока поток потоков потоками
потому: потому
потребовать: потребует
похожий: похожий
почему: почему
поэтому: поэтому
правило: правил правила
превратить: превратить
превращение: Превращение
предисловие: Предисловие
предоставить: предоставить
предоставлять: предоставляемый предоставляет
предположение: предположение
представляться: представляется
преобразование: преобразования Преобразование
преобразовать: преобразует преобразовать
преобразуется: преобразуется
приведение: приведение приведения
привести: привести
привет: Привет
приводить: приводит
приводиться: приводятся
признак: признак
прийтись: пришлось
приложение: Приложения
пример: Пример примере
примечание: Примечание
принимать: принимает принимать принимают
присвоить: присвоено
причина: Причина
проанализировать: проанализирует
проверка: проверки
программа: программы программа
программирование: программирования Программирование
программист: программистам
продвинуть: Продвинутые
проект: проектами Проект проекта
проектирование: проектирования
прозрачно: прозрачно
производительность: производительности
происходить: происходит
проследовать: проследовать
простой: простое
противный: противном
профиль: профилей
проходить: проходят
публикация: Публикация
путать: путать
путь: Пути путей
работа: Работа работы работу
работать: работает работать
рабочий: Рабочие
равный: равно равный
раз: раз
раздел: разделе раздела
разделять: разделяемого
различие: различие
различный: различных
разница: разница
разновидность: разновидность
разный: разных
разработка: Разработка разработки
разыменование: разыменования разыменование разыменований
разыменованные: разыменованные
разыменовать: разыменованное разыменуем разыменован разыменованного
разыменовывать: разыменовывать разыменовывает
рассматривать: рассматривать
рассматриваться: рассматриваться
рассмотреть: рассмотрим
расти: растущими
расход: расходов
расширение: Расширение
расширить: Расширенные
расширять: Расширяемый
реализация: Реализация реализации реализацию
реализовав: Реализовав
реализовать: реализовали реализуем реализуя реализующего реализует реализующих реализовал
реализующий: реализующий
реальный: реальным
редакция: Редакции
результат: результат результате
рефакторинг: Рефакторинг
своеобразный: своеобразную
свой: своё свои
связать: связанных связанными связанный Связанные связана
сделать: сделать
себя: себя
сервер: сервера сервер
серия: серии
сигнатура: сигнатуре
символ: символы символами
синтаксис: Синтаксис
система: системой
скобка: скобок
сколько: сколько
скопировать: скопированное
следование: следования
следовательно: Следовательно
следовать: Следуя
слово: слова
сложнее: сложнее
случай: случае случаев случаях случая случай
смочь: сможете
сначала: сначала
снова: снова
собираться: собираемся
собственный: собственный собственного
содержать: содержит
создавать: создаём
создаваться: создаётся
создание: создание
создать: создать создадим
сообщение: сообщений
соответствовать: соответствовать соответствовала соответствуют соответствует соответствующую
сопоставление: сопоставление
сосредоточиться: сосредоточимся
состояние: состоянием
список: списков
способ: способ
сравнение: Сравнение сравнении
сравнивать: сравнивать
среда: среды
срез: среза срез срезом
срок: сроков
ссылка: ссылками Ссылки ссылок ссылка ссылкам ссылку ссылке
ссылкой: ссылкой
ссылочные: Ссылочные
стандартный: стандартной Стандартная
столько: столько
стрелочка: стрелочку
строка: строками строки строке
строковый: строковый
структура: структур структуры структура структуру структурой структуре
так: так
также: также
такой: такое таким такой
текст: текста
тело: тело
теперь: теперь
тест: тестов тесты
тестирование: тестирование
тип: Типы Тип типов типа типом типу
типаж: типажи типажа типаже типаж типажей
тот: то того том тому
трактование: Трактование
требовать: требуемых требует
трейт: трейта трейтов трейт
трейты: трейты
третий: Третий
три: трёх
увидеть: увидеть
удобный: удобный
указание: указания
указатель: указателями указатели указатель указателей указателю указателем указателя
указывать: указывает указывающий указывающую
улучшение: улучшения Улучшение
умножение: умножения
умный: умными Умные умный умных умного
управление: управления Управление
управлять: Управляющие
устанавливать: устанавливаем
установить: установили
установка: Установка
устранимые: Устранимые
утверждать: утверждать
утверждение: утверждение утверждении
утечка: утечке
файл: файла файлов Файл
фактически: фактически
фактический: фактическое
финальный: Финальный
функциональность: функциональности Функциональность
функциональный: Функциональные
функционировать: функционирует
функция: Функции функцию Функция функциями функций
характеристика: характеристики
хитрее: хитрее
хотеть: хотим
хранение: Хранение
хранить: хранить хранил
храниться: хранятся хранящемуся
целочисленный: целочисленному
цикл: циклы
число: числа число
читать: читать
чтение: Чтение
что: чего Что
шаблон: шаблона Шаблоны шаблон
экземпляр: экземпляров экземпляр
элемент: элемент элементов элементом
это: это
этот: этот эту Эта этом этими эти этого
являться: является
явный: явных
язык: Язык языка языков
