автоматически: автоматически
автоматический: автоматическое
автор: автор
адрес: адресом адресу
актуальный: актуальные
аналогичный: аналогична
аналогия: аналогию
англ: англ
аннотацию: аннотацию
аннотация: аннотация аннотациями
аннотировать: аннотировать аннотированными
аннулировать: аннулирует
аспект: аспекты
базовый: базовый
байт: байтах
безопасность: безопасности безопасность
безопасный: безопасный
библиотека: библиотекой
близко: близко
более: более
больше: больше
больший: большими
большинство: большинстве
брать: берёте
быстро: быстро
быстрый: быстрее быстрые
быть: будет было быть есть будем будете будут были был была
важный: важных
вариант: вариант
ваш: вашей вашему ваш ваших
ввести: введя
ввод: ввод
вернуть: вернуть
вероятно: вероятно
версия: версия версию
верхушка: верхушке
вести: ведёт
весь: Все всех весь всего всё
взаимодействие: Взаимодействие
взаимодействовать: взаимодействовать
взаимосвязь: взаимосвязь
взгляните: Взгляните
взглянуть: взглянем
взять: Возьмём
видеть: видели видите
видимость: видимости
визуальный: визуальным
включать: включающие включать
владелец: владелец владельцами владельцем
владение: владение владения владением
владеть: владеющая
влияние: влияние
влиять: влияет
возврат: возврата возврат
возвращаемые: Возвращаемые
возвращать: возвращает возвращающей возвращать
возвращаться: возвращается
возвращение: Возвращение
возможность: возможность
возможный: возможные
время: время времени
вручную: вручную
всегда: всегда
встречаться: встречались
второй: вторая
входить: входите входят
вы: вас вам вы вами
выбирать: выбирает
выбор: выбор
выглядеть: выглядит выглядела
выдать: выдаст
выделение: выделением выделения выделение выделению
выделить: выделенными выделенные
выделять: выделять
вызов: вызов вызова
вызывать: вызывает вызываем вызывать
выполнение: выполнения выполнение выполнении
выполнять: выполнять выполняемый
выполняться: выполняется
высокопарно: высокопарно
выход: выхода
выходить: выходит выходят
выяснить: выяснить
где: где
глава: главе Главы
глубокий: глубокое глубокие глубоким
глубоко: глубоко
говорить: говорили
гораздо: гораздо
граница: границы
группа: группе группы группа
давать: давайте даёт
далеко: далеко
данные: данные данным данными
данный: данных данной данный
дать: даст
два: два две
дважды: дважды
двоеточие: двоеточие
двойной: Двойное двойного
действие: действия
действительный: действительна действительной действителен действительными
делать: делающих делали делает
дело: делом деле
демонстрация: демонстрации
дерево: дереве
держаться: Держитесь
деталь: деталях
диапазон: диапазон
дизайн: дизайна
длина: длина длиной длину длины
добавить: добавить
добавление: Добавление
добавлять: добавляете добавляем
добраться: добраться
довольно: довольно
догадаться: догадаться
документация: документацию
должный: должны должен должна должно
дополнение: дополнение
дополнительный: дополнительное
допустимость: допустимостью
допустимый: допустима
допустить: допустим
дорогой: дорогой дорогим
достаточный: достаточного
доступ: Доступ
доступность: доступность
доступный: доступные
другой: других другим Другими другой
дублироваться: дублирующихся
думать: думали думать
емкость: ёмкость ёмкостью ёмкости
естественный: естественным естественный
еще: ещё
жестко: жёстко
жизнь: жизни
забыть: забудем
завершаться: завершается
заказ: заказы заказа
заключаться: заключается
закончить: закончили
закончиться: закончится
закрывать: закрывающей
замедлить: замедлит
запрашивать: запрашиваете запрашивает
запрашиваться: запрашиваться
запрос: запроса
запятая: запятой
затем: затем
захотеть: захотим захотеть
защищать: защищают
звучать: звучит
здесь: здесь
знакомый: знакомой
знание: знание
знать: знаем знаете
значение: значение значения значений значению
значить: значит
зрение: зрения
игнорировать: игнорировать
известный: известный известно известным известен
извлекаться: извлекаются
извлечение: извлечением
извлечь: извлечены
изменить: изменить
измениться: измениться
изменять: изменяема изменяемый
изучить: изучите Изучим
иллюстрировать: иллюстрируют
иметь: имеют иметь имеет имеющей
имя: имён имя
иначе: иначе
индикатор: индикатором
инициализация: инициализация
иногда: иногда
иной: иное
информация: информации
искать: искать
исполняемый: исполняемом
использование: использования использование
использовать: используют используемой используемый использовать используя использовали использующих использует использовала
использоваться: используется
исторически: исторически
исчерпать: исчерпать
итак: Итак
итоговый: итоговом
каждый: каждого каждой каждое каждый
казаться: казаться кажется
какой: какое какие
капот: капотом
качество: качестве
класть: кладёте
клонирование: клонирования
когда: когда
код: код коду кода коде
количество: количество количества
комментарий: комментариями
компилятор: компилятором
компиляция: компиляции
компьютер: компьютера
конец: конца конце
конкретный: конкретной
контекст: контексте
концепция: концепцией концепции концепция
копирование: копирование копирования копированием копированию
копировать: копируем
копироваться: копируются
копия: копии копию
кортеж: Кортежи кортеж кортежа
который: которые которых которого которой который которая котором которым которую
краткий: краткое
кто: кто
куда: куда
курс: курсу
кусок: кусок
куча: куча куче кучи кучу
лаконичный: лаконичными
легче: легче
листинг: листинге Листинг листинга
литерал: литералу литералы
литерала: литерала
логический: Логический
локальный: локальные
любой: любого любое любая любым
маленький: меньше
медленный: медленнее медленным
менее: менее
меняться: меняться
место: место
метод: метода метод методов методы
механик: Механика
минимизация: минимизация
многий: многих Многие
многословный: многословно
модуль: модулями модулей
можно: можно
момент: момент момента
мочь: может могут можем можете могла
мусор: мусора
мы: мы нам нами нас
набор: набор набором
называть: называете называть называемый называемая
называться: называется
наиболее: наиболее
найти: найти
написание: написания
например: например
нарушение: нарушении
настоящий: настоящее
находить: находит
находиться: находится находятся
наш: наши нашей нашему нашу
недействительный: недействительным недействительную
недопустимый: недопустимая
недорогой: недорогим
независимо: независимо
независимый: независимой
неизвестный: неизвестен
неизменный: неизменны
неизменяемость: неизменяемости
неиспользуемый: неиспользуемую неиспользуемых
некоторый: Некоторые некоторое некоторых некоторого некоторой некоторыми
нельзя: нельзя
немного: немного
необходимый: необходимо Необходим необходимую
неожиданный: неожиданным
неопределенный: неопределённый
несколько: несколько
нестандартный: нестандартное
нет: нет
никакой: никакие
никогда: никогда
ничто: ничего ничем
но: Но
новость: новость
новый: новой
нужный: нужна нужно
оба: обе оба
обеспечить: обеспечить
область: область области областями областью
образ: образом
обратно: обратно
обратный: обратном
обращение: обращения
обсудить: обсудим
обсуждать: обсуждали
обсуждение: обсуждения
общий: общий общей
объем: объём объем
объявление: объявления
объяснение: объяснения
объяснить: объяснить
обычный: обычного
обязанный: обязаны
один: одна одним одну одного один одними одно одной одному
однако: Однако
означать: означает
оказывать: оказывает
он: его он него
она: ней неё её она
они: они их ними
оно: оно
оператор: Оператор
операционный: Операционная операционной
операция: операция
опираться: опираться
описать: описано
опоздать: опоздает
определенный: определённых определённый
определять: определяющих определять
опустить: опустить
опыт: опыта
организованно: организованно
освободить: освободить
освобождать: освобождать
освобождение: освобождения Освобождение
основа: основу
основный: основная
особенность: особенностей особенность
особенный: особенное
оставаться: остаётся
остальной: остальных
отличаться: отличается
отлично: отлично
отличный: отличный
относиться: относится
отслеживание: Отслеживание
отслеживать: отслеживающий
отслеживаться: отслеживается
официант: официанта
очевидно: очевидно
очень: очень
очистить: очистить очищено
очистка: очистка
очищать: очищает
очищаться: очищается
ошибка: ошибкой ошибка ошибок ошибку
память: памятью память памяти
параметр: параметры
паттерн: паттерн
первый: первым первых первого Первая первую
передавать: передавать передаём
передать: переданные передано
передача: передачи Передача
переменный: переменные переменной переменных переменную Переменная
переместить: перемещён перемещены
перемещать: перемещает
перемещаться: перемещаются
перемещение: перемещения перемещением перемещению
переходить: переходить
персонал: персонал
плавать: плавающей
поведение: поведение поведению
поверхностный: поверхностное поверхностной поверхностным поверхностного
повреждение: повреждению
поговорить: поговорим
подготовка: подготовки
поддерживать: поддерживать
подробно: подробно
подробный: подробнее
подумайте: Подумайте
подход: подход
подходить: подходят
позволить: позволит
позволять: позволяет
поздний: позже
пока: пока
показ: показа
показать: показана показанных показано показан
показаться: покажется
показывать: показывающими
покидать: покидает
полностью: полностью
получение: получения Получение
получить: получить получил получите получим полученным
пользовательский: пользовательский
поместить: помещены поместить
помечать: помечает
помещаться: помещаются
помещение: помещением помещение
помните: Помните
помочь: помочь
помощь: помощью
понадобиться: понадобятся
понимание: Понимание понимания
понять: поймёте
попробуйте: Попробуйте
попытаться: попытаться
порядок: порядке
посадить: посадили
посередине: посередине
поскольку: Поскольку
последний: последним
посмотреть: посмотреть
посмотрите: Посмотрите
потенциально: потенциально
потерять: потеряна
потому: потому
похоже: похоже
похожий: похожую
почему: почему
поэтому: Поэтому
появляться: появляется
пояснение: пояснение
правило: правил правилами Правила правилах правило
правильный: Правильное
право: право права
предел: пределы
предоставить: предоставлены
предотвратить: предотвратить
предотвращать: предотвращают
предположить: предположить
представить: представленному
представление: представление
представьте: Представьте
прежде: прежде
преимущество: преимущество
привести: привести приведёт
приводить: приводит
привыкнуть: привыкнуть
привязать: привязать привяжет привязанное
призма: призму
признать: признан
прийти: пришёл
прийтись: придётся
приложение: приложении
применимый: применимы
пример: примерах примерами примеры примера пример примере
примечание: Примечание
принимать: принимающего
принятие: принятие
принять: принять
присваивание: присваивание
присваивать: присваиваем
присвоение: Присвоение присвоения присвоении
причина: причин Причина
проблема: проблемы проблемой проблема проблему
проверить: проверить
проверка: проверки
проверяться: проверяются
программа: программа программы программе
программирование: программирования
программист: программист программистов
продолжать: Продолжая
произвести: произвести
производительность: производительности
производная: Производные
произойти: произошло
происходить: происходит
пройти: прошли
прописать: прописано
проследовать: проследовать
простой: простым простые простых
пространство: пространства пространство пространств
противоречить: противоречит
процесс: процесс процесса
процессор: процессоры процессор
прыгать: прыгают
путь: Пути путь
пытаться: пытаться пытаетесь
работа: работы работу работе
работать: работают работает работаем
равный: равны
раз: раз
раздел: разделе раздел
раздражать: раздражает
размер: размер размера размером
разместить: размещены
размещать: размещать
размещение: размещения
разница: разница разницы
разный: разному
разрабатывать: разрабатывать
ранее: ранее
рано: рано
расположить: расположить
распределитель: распределителю распределителя
рассмотреть: рассмотрим рассмотренные
реализация: реализация реализации
реализовать: реализует реализуют
реализовывать: реализовывать
реальный: реальных
регулярно: регулярно
результат: результате
ресторан: ресторане
ресурс: ресурсов ресурса
решать: решает
решение: решений
рис: рис
рисунок: рисунок рисунке
ровно: ровно
сам: сами самом
самый: самое
сборщик: сборщик сборщиком сборщика
сверху: сверху
свободный: свободный
свой: свою
связать: связаны
сдаваться: сдавайтесь
сделать: сделаем Сделать сделает сделал
сейчас: Сейчас
сидеть: сидите
символьный: Символьный
синтаксис: синтаксис
система: систему системы система системе
системный: системного
ситуация: ситуации ситуаций ситуациях
сказать: сказали
скалярный: скалярных
скобка: скобки
скомпилировать: скомпилирована
сконцентрироваться: сконцентрируемся
скопировать: скопированы скопировал скопирует скопировать
слева: слева
следовательно: Следовательно
следовать: следовать следует
следующий: следующему следующие следующую
слишком: слишком
слово: словами
сложный: сложный сложным сложной сложных
случай: случае
слышать: слышали
смотрите: смотрите
сначала: сначала
снизу: снизу
снова: снова
современный: Современные
совсем: совсем
содержать: содержит содержащей содержат содержащая
содержимое: содержимое содержимого
соединить: соединить
сожаление: сожалению
создавать: создавать
создаваться: создаются
создание: создания создание
создать: созданы создать создадим
сокращаться: сокращается
сосредоточиться: сосредоточиться
состоять: состоит
сохранить: сохранить
специальный: специальную специальная
способ: способы способ
справа: Справа
спросить: спросить
сработать: сработает
сравнение: сравнения
ссылка: ссылку ссылками
стандартный: стандартной
становиться: становилась
статический: статические
стек: Стек стеке стека
стековые: Стековые
стол: стол столов столом столу стола
стопка: стопке стопки
строка: строках строки Строка строку
строковый: строковому строковые строковое строковый строкового
структура: структуре
структурировать: структурированы
существовать: существует
сфокусировать: сфокусированы
счастие: счастью
считать: считает считать
считаться: считается
так: так
также: также
такой: такое таких такого Такой такие такими
тарелка: тарелок тарелки тарелка
текст: тексте текст текста
текущий: текущей
тело: тела
теперь: Теперь
термин: термины
тип: тип Типы типам типом типа типах типу
типаж: типажом типаж типажа типажи
тоже: тоже
тот: тем том то того той те тех теми ту тому
точка: точки
точный: Точно
требовать: требуют требует
требоваться: требуется
трейт: трейт трейта
третий: третий
три: трёх
тривиально: тривиально
туда: туда
тут: тут
убедиться: убедитесь
увеличиваться: увеличивающийся
уверенность: уверенности
увидеть: увидеть
удаление: удаление
удалять: удаляет
удаляться: удаляется
удобный: удобны
уже: уже
узнавать: узнаёт
узнать: узнали узнать
уйти: ушёл
указатель: указатель указателю указателя указатели
указывать: указывающими указывает указывают
уникальный: уникальным
упоминать: упоминаемых
управление: управление
управлять: управляет управлять
управляться: управляется
устроить: устроена
утомительный: утомительно
участок: участок участка
уязвимость: уязвимостям
файл: файле файл
фактический: фактических
фигурный: фигурной
фиксированный: фиксированный фиксированным
форма: формой
функция: функцию функция функции функцией
хватить: хватит
ход: ходе
хороший: Хорошая лучше
хотеть: хотим хотеть хотели
хотеться: хочется
хранить: хранит хранить
храниться: хранящиеся храниться хранится хранятся хранящихся
целочисленный: целочисленного целочисленные
целый: целого целые
цель: цель
часто: часто
часть: части частях часть частей
человек: человек
черта: чертой
число: числа
что: Что чем
шаблон: шаблоны шаблон шаблону
шаблонный: шаблонном
элемент: элемент элементу элемента
этап: этапе
это: это
этот: этой этого Этот эти этих этому этом Эта
эффективно: эффективно
эффективный: эффективный эффективные
являться: является являющийся являются
явно: явно
явный: явного
язык: языке языки языках языка языков языками
