автоматический: автоматических
акцентировать: Акцентированные
алфавитный: алфавитным
аналогичный: аналогичный аналогична
аннотация: аннотацию аннотации
анонимный: анонимные
аргумент: аргументов
архитектура: архитектуры архитектура
архитектурно: архитектурно
байт: Байт байта
безбоязненный: Безбоязненный
беззнаковый: беззнаковый беззнаковое
безопасность: безопасности
безопасный: безопасный
библиотека: библиотеки библиотекой
билд: билдов
бинарный: бинарных
бит: битов
бита: бита
битный: битная
бить: бит
близкий: ближайшего
более: более
больше: больше
больший: большей
большинство: большинстве
браться: берётся
будущее: будущем
буква: буквы
бумага: бумаге
быть: быть есть будет было
валидация: Валидация
вариант: вариантов вариант
варианта: Варианты
ваш: вашу вашим ваше
введение: Введение
ввести: ввести введёт
ввод: вводом
веб: веб
вектор: векторами вектор векторы
вероятно: вероятно
весь: Все всех всем всего
вид: вид виде
видимость: видимости
визуальный: визуального
включать: включает включать
включительно: включительно
владение: владения владение
вместо: вместо
внутренний: внутренняя
возврат: Возврат
возвращать: возвращаемый возвращают
возможность: возможности возможностей возможность
возможный: возможных
возникать: возникает
восьмеричный: восьмеричный
вот: Вот
время: время времени
вручную: вручную
всегда: всегда
встроить: встроенные
второй: второго
вы: вы вам вас
вывести: вывести выведено выведет
вывод: выводом
выводимые: Выводимые
вызов: вызова
вызывать: вызывает
выполнение: выполнением Выполнение выполнения выполнении
выполнить: выполнила
выполнять: выполняет
выполняться: выполняется
выпуск: выпуска
выражение: выражение выражения
вычисляться: вычисляется
вычитание: вычитание
где: где
гибкий: гибок
глава: главы главе
говорить: говоря
группировать: группировать
давать: Давайте
далее: далее
данные: Данных данные данными
данный: Данная данный данному данном
два: два двух
двоичный: Двоичный
двойной: двойной двойные
действие: действия действии
деление: деление
демонстрировать: демонстрирующий
дерево: дереве
деструктуризация: деструктуризации деструктуризацией
десятичный: Десятичный десятичной
диапазон: диапазона диапазоне
длина: Длина длину длины длине
добавить: добавить добавим добавили
добавление: добавления
добавлять: добавлять
должный: должен должны должно должна
дополнение: дополнения
дополнительный: дополнительного
допускать: допускающих допускают
допустимый: Допустим допустимые
доступ: доступ доступа
дробный: дробной
другой: другим Другими других другого
его: его
единичный: единичное единичный единичного
единый: единый
жизнь: жизни
забывать: забывайте
завершаться: завершается
завершение: завершение
завершиться: завершилась
зависеть: зависят
зависимый: зависимая
загадать: загаданным
загадка: загадки
задаваться: задаётся
задать: задано
заимствование: заимствование
закодировать: закодированного
закрываться: закрываясь
заметьте: Заметьте
замыкание: замыкания
занимать: занимает
запаниковать: запаникует
записывать: записывать записывая записываем
записываться: записываются записывается
запись: Запись
запускать: запускаете
запустить: запустить
запятая: запятой запятыми
затем: Затем
захватывать: захватывают
защищать: защищает
здесь: Здесь
знак: знака знаком знак
знаковый: знаковый знаковое знаковыми
знакомый: знакомы
знать: знать знаете
значение: значений значениями значения значение значении значениям значением
значить: значит
игра: игры игру
известный: известного
изменить: изменить
изменяемость: изменяемость
изменять: изменять
иметь: имеет иметь имеющие имеют имеющий
иметься: имеется
имя: имя именем
индекс: индекс индексы индексу
индексация: индексация индексации
индексирование: индексирования
индикатор: индикатор
инициализировать: инициализировать
инструкция: инструкции инструкциях инструкцию
инструмент: инструменты
информация: информации
использование: Использование использованием использовании использования
использовать: использующей использовать использовали использует используя
использоваться: использоваться используется используются
итератор: итераторы итераторов
кавычка: кавычками кавычки
каждый: Каждое Каждый каждую Каждая каждому каждого
какой: какой какое
качество: качестве
квадратный: квадратных
китайский: китайские
ключ: ключей
ключевой: ключевого Ключевые
книга: книги
когда: когда
код: кода код коде коду
кодировка: кодировке
количество: количество
коллекция: коллекции
команда: команд
командный: командной
комментарий: Комментарии
компилироваться: компилируется
компилятор: компилятор компилятору
компиляция: компиляции компиляция
компьютер: компьютера
конвертировать: конвертировали
конструкция: конструкции Конструкция
конфиденциальность: конфиденциальностью
концепция: концепции
корейский: корейские
кортеж: кортежи Кортеж кортеже кортежем кортежа
который: которые который которая которым которое котором которых которой
краткий: краткой
крейт: крейтов крейты крейта
кроме: Кроме
круглый: круглых
куча: куче кучу
лаконичный: Лаконичный
литерал: литералы литерал литералов
логический: логический логических
лучше: лучше
любой: любой
макрос: Макросы
максимальный: максимальное максимальным
массив: массивы массив массива массивов массиве
математический: математические математический
меньше: меньше
место: места
месяц: месяцев
метод: метода методов
минимальный: минимальному минимальным
минус: минус
мир: Мир
многий: многих
многопоточный: многопоточного многопоточный
модуль: модулей
модульность: модульности
можно: можно
мочь: могут может можем можете
мы: Мы нас
мягкий: Мягкое
наверняка: наверняка
название: названия
называться: называется
наконец: Наконец
напечатать: напечатает
написание: Написание
написать: написать
направление: направлении
например: Например
напрямую: напрямую
настройка: Настройка
насыщение: Насыщение
находиться: находятся находится находящемуся
начало: начала
начать: начать
начинаться: начинаются
наш: нашего
небезопасный: Небезопасный
недопустимый: недопустимого
некорректный: Некорректный некорректным
некоторый: некоторых
немедленно: немедленно
необходимый: необходимо
необязательный: необязательные
неправильный: неправильный
несколько: несколько нескольких
неустранимый: Неустранимые
неявно: неявно
низкоуровневый: низкоуровневых
никакой: никакого
номер: номером
нужный: нужно
нулевой: нулевой
нуль: нуля
обертывание: обёртывание обёртывания
обеспечение: обеспечения
обладать: обладает
область: областью область области
облегчение: облегчения
обобщенные: Обобщённые
обозначаться: обозначаются обозначается
обозначение: обозначения
оборачиваться: оборачиваются
обработка: Обработка обработки
образ: образом
образец: образцом
обращаться: обращается
обрезать: обрезает
обсудить: обсудим
обсуждаться: обсуждается
общий: Общие общим
объединение: объединения
объект: объектов
объектный: объектно
объявление: объявление объявления
обычно: Обычно
обычный: обычными
обязательно: обязательно
один: один одному одно одним
одинаковый: одинаковыми
одинарный: одинарной одинарными
однако: однако
однопоточный: однопоточного
ожидание: ожиданиям
означать: означает
окружение: окружение
он: он ним ему
они: они
оно: оно
оператор: Операторы оператор операторов
операция: операции операцию
определение: Определение
определенный: определённому
определять: определяет
опровержимость: Опровержимость
организация: Организация
ориентировать: ориентированного ориентированных
основной: Основной
основный: основных основные
основываться: основываясь
особенно: особенно
остаток: остаток
отдельный: отдельные
отладка: отладки
отличие: отличие
относиться: относится
отображаться: отображается
отобразить: отобразит
отрицательный: отрицательным
очистка: очистке очистка
ошибка: ошибок ошибки ошибках ошибку ошибкой ошибке
пакет: пакетов Пакеты
память: памяти
паника: панике паника панику
паниковать: паникует
параллелизм: параллелизм
параллельный: параллельного
первый: первый
перевод: Переводы
передача: передачи
переменный: Переменные переменными переменных переменная переменную переменной
переполнение: переполнение переполнения переполнении
пересылка: Пересылка
перечисление: Перечисления
печатать: печатает
писать: писать
плавать: плавающей
поведение: поведения поведение
поддерживать: поддерживает
подмножество: подмножества
подробнее: Подробнее
подробно: подробно
подсчет: подсчётом
подходить: подходят
позволять: позволяет
позиция: позиция
показать: показанную показаны показанных показано
показывать: показывает показывающее
полагаться: Полагаться
полезный: Полезные полезны
положительный: положительным положительное
получение: Получение
получить: получить получит
пользователь: пользователя пользователь
пользовательский: пользовательских
помощь: помощью
понимание: Понимание
понятие: понятием
попытаться: попытаться
попытка: попытке
последовательность: последовательности
последующий: последующем
посмотреть: посмотрим
поток: потока поток потоков потоками
потому: потому
похожий: похоже похожий
поэтому: поэтому
правило: правило
превращаться: превращается
превращение: Превращение
превышать: превышающие
предел: пределами
предисловие: Предисловие
предоставлять: предоставляемых предоставляет предоставляемый
предположение: предположения
предположить: предположить
представить: представлено представлены
представление: представление
представлять: представляет представляющих представлять
предыдущий: предыдущем
привести: привести
привет: Привет
приводить: приводящую
привычный: привычные
приложение: Приложения Приложении
применение: применения
пример: Пример примеров примере
примерно: примерно
примитивный: примитивных примитивным
принцип: принципов
причем: причём
пробел: пробелы
проверка: проверку проверки проверка
проверять: проверяет
программа: программы программа программу программе
программирование: программирования Программирование
продвинуть: Продвинутые
продолжать: продолжать
проект: проектами Проект проекта
проектирование: проектирования
производительность: производительности
произойти: произойдёт произошло
происходить: происходить
профиль: профилей
процессор: процессорах
проще: Проще
публикация: Публикация
пустой: пустое пустой
путь: Пути путей
работа: Работа работы работу
работать: работать работаем работают работает
рабочий: Рабочие
равно: равно
равный: равен
разбивать: разбивает
раздел: разделе
разделитель: разделителя
разделить: разделённых разделённого
разделять: разделяемого
различный: различные различными различных
размер: размер размерах размере размера
разместить: разместить размещён
разный: разных
разобраться: разберёмся
разработка: Разработка разработки
разрешать: разрешать разрешает
рассматриваться: рассматриваются
рассмотреть: рассмотрим
расти: растущими
расширение: Расширение
расширить: Расширенные
расширять: Расширяемый
реализация: Реализация
редакция: Редакции
режим: режиме режимах
рефакторинг: Рефакторинг
род: рода
самый: самым
свой: своё
связать: связанных связанными связано связана
связывать: связывает
связываться: связывается
себя: собой
семейство: семейство
сервер: сервера сервер
символ: символы символ
символьный: Символьный
синтаксис: Синтаксис
скалярный: скалярные Скалярный скалярных скалярное
скобка: скобок
скобках: скобках
скорость: скоростью
скорый: скорее
след: Следом
следовательно: следовательно
следовать: следует
следующий: следующую Следующий следующим следующее
слово: слова словами
сложение: сложение
случай: случаях случай случае
сначала: сначала
совпадать: совпадать
современный: современных
содержать: содержит содержать содержащий
создавать: создаём создаёт
создаваться: создаётся
создание: создание создания
сообщение: сообщений сообщением
соответственно: соответственно
соответствие: соответствии
соответствовать: соответствовать соответствующий
соответствующий: соответствующие соответствующее
сопоставление: сопоставление
составлять: составляет
составной: составные составных составной составным
состояние: состоянием
специальный: специальное
список: списков список списка
способ: способ способом
сравнение: Сравнение
среда: среды
срез: среза
срок: сроков
ссылка: Ссылки ссылок ссылками
ссылочные: Ссылочные
стандарт: стандартом
стандартный: стандартной
становиться: становится
статически: статически
стек: стеке стек
столкнуться: столкнулась
строка: строками строки строк
строковый: строковых
структура: структур структуры
суффикс: суффикса
существовать: существует
считаться: считается
таблица: Таблице Таблица
так: так
также: также
такой: такое такую Такая Таким таких такого
текст: текста
тема: тему
термин: термин
тест: тестов тесты
тестирование: тестирование
тип: Типы Тип типов типу типа типами типом
типаж: типажи
типизированный: типизированным
тот: том того той тем тот то
точка: точкой точку точки точка
точность: точностью точности
требовать: требуемого
требоваться: требуется
трейт: трейта трейтов трейт
трейты: трейты
три: три
увеличиваться: увеличиваться
уверенность: уверенностью
уверить: уверены
увидеть: увидите
угадывание: угадывание
удобный: удобно
узнать: узнать
указание: указания
указатель: указатели указателями указатель
указать: указано указав указанный
указывать: указывает указывающий указываем указываете
улучшение: улучшения Улучшение
уменьшаться: уменьшаться
умножение: умножение
умный: Умные умными умный
умолчание: умолчанию
универсальный: универсальный
управление: управления Управление
управлять: Управляющие
условие: условий
успешно: успешно
установка: Установка
устранимые: Устранимые
утечка: утечке
файл: файла файлов Файл
фиксировать: фиксированную фиксированным фиксированного
финальный: Финальный финальную
флаг: флагом
форма: форм
фрагмент: фрагмент
функциональность: функциональности
функциональный: Функциональные
функция: Функции
характеристика: характеристики характеристика
хотеть: хотим
хранение: Хранение
хранить: хранить
храниться: хранятся
целочисленные: Целочисленные
целочисленный: целочисленный целочисленного Целочисленное
целый: целым целых целого
цикл: циклы
часть: части
человеческий: человеческое
четыре: четыре
число: число числа числом чисел
числовой: числовые числовых Числовой числовую
читать: читаемый
чтение: Чтение чтения
что: чего Что
шаблон: шаблона Шаблоны шаблон
шестнадцатеричный: Шестнадцатеричный
ширина: ширины
экземпляр: экземпляров
элемент: элемент элементов элементом элементу элемента элементам
эмодзь: эмодзи
этап: этапе
это: Это этим
этот: этими этих этот этого эту этом Эта
являться: является являются
явный: явный явной
язык: Язык языка языков языком языкам языках
японский: японские
