автоматически: автоматически
автоматический: автоматических
активный: активной
аналогичный: Аналогичным
анонимный: анонимные
аргумент: аргументов
базовый: базовым
байт: байта байтов байт
байтовый: байтового
безбоязненный: Безбоязненный
безопасность: безопасность
беспокоиться: беспокоиться
библиотека: библиотеки
билд: билдов
бинарный: бинарных бинарного
более: более
больше: больше
брать: брать
будущее: будущем
быть: быть есть будет были был будете будем
валидация: Валидация
ваш: ваш ваша
введение: Введение введения
ввод: вводом
веб: веб
вектор: векторами векторах
вернуть: вернуть вернёт
версия: версии
весь: Все всю вся всё всей всех
взять: взять
вид: вид видов
видимость: видимости
включать: включает
владелец: владелец
владение: владения владение
влиять: влияет
вместо: вместо
внутренний: внутренняя
возвратить: возвращена
возвращать: возвращает возвращающая возвращаемый возвращаем возвращал
возможность: возможности возможностей
вообще: вообще
воспользоваться: воспользуемся воспользоваться
время: время
второй: второй
вхождение: вхождение
вы: вы вам
вывод: выводом
выводимые: Выводимые
выглядеть: выглядеть выглядит
вызов: вызова вызове
вызывать: вызываем
выполнение: выполнением Выполнение выполнения
выпуск: выпуска
выходить: выходит
вычислять: вычислять
гарантировать: гарантирует
гарантия: гарантии
где: где
гибкость: гибкость
глава: Главе главы
говорить: говорить говорили
гораздо: гораздо
граница: границах границы
группировка: группировку
давать: Давайте даёт
далее: Далее
данные: Данных данные данными данным
данный: данный Данная данной
два: двумя
двоичный: двоичного
действие: действия
действительный: действительным действительными
делать: делают делает
дело: деле
дерево: дереве
деструктурирование: деструктурирования
диаграмма: диаграмме
диапазон: диапазон диапазона
длина: длину длины
добавление: добавления
должный: должна должны
дополнительный: дополнительном дополнительный
допускать: допускающих
допустимый: допустимых
другой: Другими Другие других
единица: единицу
ее: Её
еще: ещё
жизнь: жизни
завершаться: завершается
завершение: завершение
завершиться: завершится
загадка: загадки
заимствование: заимствование заимствования
закодировать: закодированного
замыкание: замыкания
запись: Запись
запрещать: запрещает
затем: затем
захватывать: захватывают
захотеть: захотеть
здесь: здесь
знание: Знание
знать: знайте знаем
значение: значений значениями значения значение значением
игра: игры
изменение: изменения изменений
измениться: изменилось
изменяемость: изменяемость
изменяемый: изменяемую изменяемой
иметь: имеет имеющий
индекс: индекс индекса индексом индексами Индексы индексов
инструмент: инструменты
информация: информацию
искать: ищем ища
использование: Использование использования использованием
использовать: использующей используя использовать используем использует
использоваться: использоваться используется
испортить: испортить
итак: Итак
итератор: итераторы итераторов итератор
итог: Итоги
каждый: каждый
какой: какой
качество: качестве
квадратный: квадратных
класс: класс
ключ: ключей
ключевой: ключевого Ключевые
книга: книги
код: кода код кодом
количество: количества
коллекция: коллекции коллекцию коллекций
команда: команд
командный: командной
комментарий: Комментарии
компилируется: компилируется
компилятор: компилятор
компиляция: компиляции компиляция
конец: конца конец
конечный: конечный конечного
конкретный: конкретную
конструкция: конструкции Конструкция
контекст: контексте
контроль: контроль
конфиденциальность: конфиденциальностью
концепция: концепции концепций концепциях
кортеж: кортежа кортеж кортеже
который: которые которая которое которую который котором
крейт: крейтов крейты крейта
кусок: куске
куча: куче
лаконичный: Лаконичный
листинг: Листинге Листинг листинга
литерал: литерала литералы литералах литералов
логически: логически
макрос: Макросы
массив: массив массиву массива
место: места
метод: метода метод методами
минус: минус
мир: Мир
многопоточный: многопоточного многопоточный
множество: множество
модуль: модулей
модульность: модульности
можно: можно
момент: момент
мочь: могут может могли можем могла можете
мы: мы нас нам
мягкий: Мягкое
написание: Написание
написать: напишите написали напишем написал
напомнить: Напомним
напрямую: напрямую
нарушать: нарушая
настройка: Настройка
находить: находит находим
находиться: находится
начало: начало
начальный: начальный начальную начального
начать: начать
наш: нашего нашу наш нашим
небезопасный: Небезопасный
небольшой: небольшая
невозможный: невозможной
недействительный: недействительным
неизменяемый: неизменяемая неизменяемой неизменяемы
немедленный: немедленных
немного: немного
необходимость: Необходимость
необходимый: необходимо
неправильный: неправильным
непрерывный: непрерывную
несвязанный: несвязанные
нет: нет
неустранимый: Неустранимые
неявный: Неявное
номер: номер
нужный: нужно
оба: оба
обеспечение: обеспечения
обеспечивать: обеспечивают
область: областью область области
обобщенные: Обобщённые
обозначение: обозначения
обозначить: обозначенного
оборачивать: оборачивает
обработка: Обработка обработки
образ: образом
образец: образцом
обрезать: обрезать
обсудить: обсудим
обсуждение: обсуждение
общий: Общие общим общий
объединение: объединения
объект: объектов
объектный: объектно
обычный: обычными
один: одного одно одному одну
однако: Однако
одновременный: одновременное
однопоточный: однопоточного
означать: означает
окружение: окружение
он: он его
она: она
они: они
оно: оно
оператор: Операторы
определение: Определение
определенный: определённом
опровержимость: Опровержимость
опытный: опытный
организация: Организация
ориентировать: ориентированного ориентированных
основа: основе
остаться: останутся оставшихся
отбросить: отбросить
отдельный: отдельное
отлаживать: отлаживать
отображать: отображает
отслеживать: отслеживаем
очистить: очистили
очистка: очистке очистка
очищать: очищает
ошибка: ошибок ошибки ошибках ошибке ошибкам ошибкой ошибку Ошибка
пакет: пакетов Пакеты
память: памяти
параллелизм: параллелизм
параллельный: параллельного
параметр: параметра параметр параметры
первый: первое Первый первого первая
перевод: Переводы
передать: передать
передача: передачи
перейти: перейдём
переменный: Переменные переменными переменной
переписать: перепишем переписать
пересылка: Пересылка
перечисление: Перечисления
писать: писать
поведение: поведения
подверженный: подверженной
подробнее: Подробнее
подробно: подробно
подробный: подробное
подсчет: подсчётом
позволять: позволяют позволяет
поздний: позже
позиция: позицию позиция
показать: показано показанную
показывать: показывал
полезный: Полезные полезным
получать: получаем
получение: Получение получения
получить: получить полученную получили
пользователь: пользователь
пользовательский: пользовательских
помощь: помощью
помять: Помните
понимание: Понимание
понимать: понимаем
понять: понять
попробовать: попробуем
попытаться: попытаетесь попытаемся
порядок: порядке
поскольку: Поскольку
последний: последняя последний
последовательность: последовательности последовательность
последующий: последующего
потеря: потери
поток: потока поток потоков потоками
потому: потому
почему: почему
поэлементный: поэлементно
поэтому: поэтому
правило: правил
правильно: правильно
право: права
превращение: Превращение
предисловие: Предисловие
предполагать: предполагаем
представить: представить
представлять: представляющий
преимущество: преимущества
преобразовать: преобразуем
приведение: приведения приведение
привести: привести приведёт
привет: Привет
приводить: приводит
привязать: привязаны привязанное
приложение: Приложения
пример: Пример
примечание: Примечание
принимать: принимает
пробел: пробелами пробела пробелом пробел
проблема: проблема проблему проблемы проблеме
проверить: проверить
программа: программы программу программа программе программах
программирование: программирования Программирование
продвинуть: Продвинутые
проект: проектами Проект проекта
проектирование: проектирования
производительность: производительности
просмотреть: просмотреть
простой: простой
противный: противном
протяжение: протяжении
профиль: профилей
проявиться: проявятся
публикация: Публикация
пустой: пустой
путь: Пути путей
работа: Работа работы
работать: работать работает
рабочий: Рабочие
равный: равны
раздел: разделе раздел
разделить: разделённых
разделять: разделяемого
разный: разных
разработка: Разработка разработки
рамка: рамки
ранний: раньше
располагаться: располагаться
рассмотреть: рассмотрим
рассчитать: рассчитаны
расти: растущими
расширение: Расширение
расширить: Расширенные
расширять: Расширяемый
реализация: Реализация
редакция: Редакции
результат: результат результата
рефакторинг: Рефакторинг
решение: решение
решить: решат
рисунок: Рисунок
род: рода
сам: самом сам
самостоятельно: самостоятельно
свой: своё своего
связать: связанных связанными связано
сделать: сделали
себя: себе
сервер: сервера сервер
сигнатура: сигнатуру сигнатура
символ: символы символов символа
синтаксис: Синтаксис
синтаксисом: синтаксисом
синхронизировать: синхронизировать
синхронизироваться: синхронизируется
системный: системного
скобка: скобках
следующий: следующим
слово: слова слов слово словами
сложнее: сложнее
случай: случае
совсем: совсем
содержать: содержащим
содержимое: содержимого содержимое
создавать: создаём
создаваться: создаётся
создание: создание
создать: создать
сообщать: сообщают
сообщение: сообщений
соответствовать: соответствовать соответствует
сопоставление: сопоставление
сослаться: сослаться
состояние: состоянием состоянии состоянию
состоять: состоять состоит
сохранение: Сохранение
сохранить: сохранили
сохранять: сохраняет сохраняя
специфичны: специфичны
список: списков
способ: способа способ
сравнение: Сравнение
среда: среды
срез: среза срезы Срез срезов срезе
срезом: срезом
срок: сроков
ссылаться: ссылаться ссылается
ссылка: Ссылки ссылок ссылками ссылкой ссылку ссылка
ссылочные: Ссылочные
становиться: становится
стать: стало стал
строка: строками строки строку строке строка строкой строк
строковый: строковые Строковый строковых строкового
структура: структур структуры структура
существование: существование
существовать: существует
счастие: счастью
так: так
также: также
такой: такое Таким
текст: текста
теперь: Теперь
тест: тестов тесты
тестирование: тестирование
тип: Тип Типы типов типа
типаж: типажи
тот: того то том ту
точка: точками точку
точно: Точно
трейт: трейта трейтов трейт
трейты: трейты
три: три
удобнее: удобнее
узнать: узнать
указание: указания
указатель: указатели указателями указатель
указать: указанную указав
указывать: указываем указывающего указывающий
улучшение: улучшения Улучшение улучшению
умный: Умные умными умный
управление: управления Управление
управлять: Управляющие
упростить: упростил
успешно: успешно
установка: Установка
устранимые: Устранимые
устранить: устранил
утечка: утечке
утомительный: утомительной
файл: файла файлов Файл
финальный: Финальный
формат: формате
фрагмент: фрагмент фрагмента
функциональность: функциональности
функциональный: Функциональные
функция: Функции функцию функция функциями
характеристика: характеристики
хотеть: хотим хотите
хранение: Хранение
хранить: хранит
храниться: хранящихся
хрупкий: хрупким
целый: целый
цель: целях
цикл: циклы цикле цикла
часть: части часть частей
число: число
чтение: Чтение
что: чего Что чем
шаблон: шаблона Шаблоны шаблон шаблоне
экземпляр: экземпляров
элемент: элемент элементов
это: это этого этому
этот: этой этими этом Этот эту Эта эти этих
являться: является являются
язык: Язык языка языков языки
