быть: быть
вариант: вариантов
ваш: вашем
возможный: возможных
выражать: выражает
выражение: выражении
глава: главе
далее: Далее
данные: данные
его: его
запускать: запускать
затем: Затем
значение: значения значение значений
использовать: используем
код: код коде
конструкция: конструкция
который: которое
лаконичный: лаконична
легко: легко
мочь: может
мы: мы
название: названием
называть: называемые
наконец: Наконец
насколько: насколько
ничто: ничем
обработка: обработки
образец: образцом
объединить: объединить
оно: оно
определить: определить определим
особенно: особенно
перечисление: Перечисления перечисление перечислений
позволять: позволяют позволяет
показать: показать
полезный: полезное
путь: путём
разный: разный разных
рассмотреть: рассмотрим
сначала: Сначала
сопоставление: сопоставление
также: также
тип: тип
тот: то
удобный: удобна
узнавать: узнаем
этот: этой
