абстрактный: абстрактную
абстракция: абстракцию
аналог: аналогами
аналогичный: Аналогично
аргумент: аргументов аргументом
библиотека: библиотека библиотекой библиотеки
блок: блок
более: более
больший: большую наибольшее большей
большинство: большинства
большой: большое большом
бороться: боролись
браться: берётся
буква: буквы
быть: будем быть будет было был будут были
вариант: вариантами вариантах варианта вариант
ваш: вашем ваша
везде: везде
версия: версия
весь: всех все
взять: взят
вид: вида
видеть: видите
влиять: влияют
внимание: внимание
возвращать: возвращаемого возвращает возвращая возвращать
возможный: возможных возможно
возникать: возникали возникают
вопрос: вопросом
время: время
вручную: вручную
всегда: всегда
встречать: встречаете
встречаться: встречалась
вы: вы вам
выбор: выбором
выбрать: выбрать
вывести: выведет
выглядеть: выглядит
вызвать: вызвать
вызов: вызове Вызов вызова
вызываться: вызывается
выполнение: выполнения
выполнить: выполнены
выполнять: выполняет
выразить: выразить
вычислять: вычисляет
где: где
генерировать: генерирует
гибкий: гибким
глава: главе
давать: Давайте
далеко: далеко
данные: данных данные
данный: Данный
дать: дать
два: две двух два
делать: делаем делать делали делает
делаться: делается
длина: длиной
добавить: добавленным
должный: должны должен должно
дополнение: дополнение
дополнительный: дополнительные
достигаться: достигается
доступный: доступные
другой: другое другие другой
дублирование: дублирование дублированием
дублировать: дублируемого
еще: ещё
задаться: задаться
задействовать: задействовать
заменять: заменяя
заменяться: заменяется
заполняться: заполнялось
запускаться: запускается
затем: затем
здесь: здесь
знать: знал
значение: значения значение значений значениями значением
значит: значит
идентификатор: идентификатор
избавиться: избавимся
извлечь: извлекли
издержка: издержки
изменить: изменим
иллюстрация: иллюстрации
именование: именование
иметь: имеет имеют имеющее иметь имеющей
имя: именем имя имени имена имён
информация: информации
использование: использованием использования использовании использование
использовать: используем использовать используя использующую использующих использующая использующие использовало использовали использованного используют использует использующий используемых использующего использованы
использоваться: используется использующимися используются использующихся использовавшихся
исправить: исправим
итог: итоге
каждый: каждая каждом каждое
какой: каким какие какой
код: кода код коде
количество: количестве
компилировать: компилирует
компилироваться: компилироваться компилируется
компилятор: компилятор компилятора компилятором
компилятору: компилятору
компиляция: компиляции
конец: концу
конечный: конечном
конкретный: конкретными конкретные конкретным конкретный конкретных
концепция: концепцию
координата: координат координатами
короткий: короткими
который: которые которых который которое которую которая которой
листинг: Листинг листинге
любой: любой любого
макрос: макроса
математический: математические
медленный: медленнее
мелкий: мелкие
место: местах места
метод: методы методов методом метода метод методу
много: много
можно: можно
мономорфизация: мономорфизации Мономорфизация мономорфизацию
мономорфизированный: Мономорфизированная
мочь: можем можете могут может могли
мы: Мы нам нас
название: названия
написать: написанные
например: Например
насколько: насколько
находить: находит
находиться: находится
наш: нашей наш нашему наша
независимо: независимо
некоторый: некоторые
необязательный: необязательного
несколько: нескольких несколько
несоответствие: несоответствия
неуспешный: неуспешно
никакой: никакого никакие
ничуть: ничуть
новость: новость
новый: новой новый
нотация: нотации
нужный: нужно
оба: оба
обобщенный: Обобщённые обобщёнными обобщённого обобщённому обобщённую обобщённой обобщённых обобщённый обобщённым обобщённом обобщённое
обобщить: обобщена
обрабатывать: обрабатываемых
образ: образом
обратите: Обратите
обсудить: обсудим
объединить: объединим
объявив: Объявив
объявить: объявить объявлены
объявление: объявления объявлении объявление
объявлять: объявлять объявляем объявляемой
объявляться: объявляются
обычно: обычно
ограничение: ограничения
ограничить: ограничим
один: одну одной один одном одного одно
одинаковый: одинаковое одинаковый
означать: означает
он: его он
она: её она неё
они: их они них
оно: оно
операция: операции
определение: определение определении определения определению определениях определением определений определениями
определить: определить определили определены
определять: определяем определяет определяющий
открытие: открытии
открыть: открыт
отличаться: отличаются
отличающиеся: отличающиеся
отличный: отличный отличное отличные
относиться: относятся
очевидный: очевидным
очень: очень
ошибка: ошибку ошибка
параметр: параметр параметра параметров параметры
параметризация: параметризации
передать: переданной
переменный: переменной переменная
перечисление: перечисления перечислений перечисление
плавать: плавающей
платить: платим
поговорить: поговорим
поддерживать: поддерживают
подсказка: подсказке
подставить: подставлен
подстановка: подстановки
поздний: Позже
пока: пока
показать: показано показанные показана
показывать: показывает
поле: полях поля поле
получить: получим
поместить: поместим
помощь: помощью помощи
понятный: понятно
поскольку: Поскольку
после: после
посмотреть: посмотрим
потому: потому
похожий: похож
поэтому: поэтому
превращение: превращения
предоставить: предоставленное
предоставлять: предоставляем
предотвращая: предотвращая
применяться: применяется
пример: пример примере примером примера
примерно: примерно
присваивать: присваиваем
проблема: проблемы
программа: программу программа
программист: программистов
продемонстрировать: продемонстрировать
продублировать: продублировали
производительность: производительность
произвольный: произвольный
просматривать: просматривает
противоположный: противоположные
процесс: процесс процессе процесса
путем: путём
работать: работать работает работала
раз: раз
разбить: разбить
разворачивать: разворачивает
раздел: раздела разделе
различный: различными
размещать: размещаем
разный: разных
разрешить: разрешены разрешено
ранее: ранее
ранний: раньше
рассмотреть: Рассмотрим
реализация: Реализация
реализовать: реализовать реализует реализуем
самый: самое самым
свой: своего своих
сейчас: сейчас
сигнатура: сигнатурах сигнатуры
сигнатуре: сигнатуре
символ: символ
синтаксис: синтаксиса Синтаксис
ситуация: ситуации ситуацию
скобка: скобки скобок скобках
сколь: сколь
скомпилировать: скомпилируем
скомпилироваться: скомпилируется
следующий: следующую следующем
следуя: Следуя
слово: слова
случай: случае
смотреть: смотрите
сначала: сначала
совет: совету
совпадать: совпадают
соглашение: соглашению
содержать: содержащая содержит содержащий
содержаться: содержащихся
создавать: создаёт
создание: создания
создать: создадим создаст созданными
сокращение: Сокращение
сообщать: сообщаем
сообщение: сообщении
специализированный: специализированные
список: списком
сравнение: сравнения
сравнивать: сравнивать
сравнить: сравнить
сразу: сразу
срез: срезе срезом срез
ссылка: ссылку
стандартный: стандартным стандартная стандартной
стоить: стоит
строковый: строковый
структура: структур структуры структуру структура структуре структурой
считывать: считывает
так: так
также: также
такой: таким такого
тело: Тело теле
теперь: Теперь
тип: типы типами типа типом типов типу тип
типаж: типажом типажи типаж
тогда: тогда
тот: те теми тех тот того то том тем
точка: точка точки точкой
точно: точно
требоваться: требуется
треугольный: треугольные треугольных
тяжелый: тяжело
угловой: угловых
угодно: угодно
удобный: удобно
уже: уже
указание: указания
указать: указать
указывать: указываем указывает указывали
универсальный: универсальным
упоминать: упоминали
упоминаться: упоминается
упорядочить: упорядочить
успешно: успешно
устранить: устранить
файл: Файл файла
функциональность: функциональность
функция: функций функции функцию функцией Функция
хороший: Хорошая
хотеть: хотим
хранить: хранить
целочисленный: целочисленное
целый: целым целого
цель: Цель
часть: части
число: числом числа
читать: читать
читаться: читается
чрезвычайно: чрезвычайно
что: что
чтобы: Чтобы
шаг: шаги
экземпляр: экземпляр экземпляра экземпляры экземпляров экземплярах экземпляре
это: это
этот: этих Эта этого этом эту Этот этой
эффективный: эффективными
являться: является являлся являются
язык: язык
