абсолютный: абсолютный абсолютные абсолютного
автоматический: автоматических
автор: автор
аналогично: аналогично
аннотировать: аннотировать
анонимный: анонимные
аргумент: аргументов
ассоциированный: ассоциированную
безбоязненный: Безбоязненный
библиотека: библиотеки
библиотечный: библиотечного библиотечному библиотечным библиотечный
билд: билдов
бинарный: бинарных бинарным бинарного бинарный бинарном
более: более
больший: большей
будущее: будущем
бывать: бывают
быстро: быстро
быть: есть будет будут быть было
валидация: Валидация
вариант: варианты
ваш: вашей вашего ваш вашим вашем
введение: Введение
ввод: вводом
веб: веб
вектор: векторами
вернуться: Вернёмся
вероятность: вероятностью
весь: Все всё всего
взаимодействовать: взаимодействовать
вид: видов
видеть: видеть
видимость: видимости
владение: владения владение
вместе: вместе
вместо: вместо
внешний: внешнего внешних внешнему внешний
внимание: внимание
внутренний: внутренняя внутреннего внутренние внутреннему
внутри: внутри
возможность: возможности возможностей возможность
время: время
второй: Второй
вы: Вы вам
выбирать: выбирать
выбор: Выбор
выбрать: выбрать
вывод: выводом
выводимые: Выводимые
выгода: выгоду
вызвать: вызвать
вызов: вызова Вызов вызове вызовы
вызывать: вызываем вызывать вызывает
выполнение: выполнением Выполнение выполнения
выпуск: выпуска
выходить: выходят
выяснить: выяснить
где: где
глава: Главе
говорить: говорят говорит
давать: Давайте даёт
далее: Далее
далекий: дальше
данные: Данных данные
два: двух два
двоеточие: двоеточиями
двойной: двойными
действие: действия
действительный: действителен
делать: делать делает Делаем
дерево: дереве дерева Дерево
деталь: детали деталей
добавить: добавив
добавление: добавления Добавление
добавлять: добавляем
должный: должно должна должны
дополнительный: дополнительных
допускать: допускающих
досадный: досадно
достаточно: достаточно
доступ: доступа доступ
доступный: Доступные
дочерний: дочерних дочерние дочернем
друг: друг друга другом
другой: другой Другими другие другим другое
думать: думаем
его: его
еда: едой еду
ее: её
еще: ещё
жизнь: жизни
завершение: завершение
зависеть: зависеть
зависимость: зависимость
загадка: загадки
задний: задней
заимствование: заимствование
заказ: заказ
закодировать: закодированного
замыкание: замыкания
запись: Запись
запуск: запуска
запустить: запустить
затем: Затем
захватывать: захватывают
знать: знать знаете знаем
значение: значений значениями значения значение
игра: игры
идентификатор: идентификатор идентификаторов
идти: идёт
извлечь: извлечь
изменение: изменения изменениями
изменяемость: изменяемость
изменять: изменять
иметь: имела иметь имеет имел
имя: имени именем имя
инструмент: инструменты
интересный: интересна
искать: ищем
исключение: исключением
исполнять: исполняемый
использование: Использование использованием использованию использования
использовать: использующей используем использует использовать использующим используя использовали
использоваться: использоваться использовался
исправлять: исправляет
исходить: исходя
итератор: итераторы итераторов
каждый: каждый каждое каждом
какой: какой какие какую
качество: качестве
клиент: клиентов клиенту клиент клиенты
ключ: ключей
ключевой: ключевого Ключевые ключевым ключевое
книга: книги
код: кода код кодом коду
коллекция: коллекции
команда: команд
командный: командной
комментарий: Комментарии
комментирование: комментирование
компилироваться: компилируется
компиляция: компиляции
конкретный: конкретном
консольный: консольной
константа: константы
конструкция: конструкции Конструкция
контейнер: контейнерами
контекст: контекст
контракт: контракт
конфиденциальность: конфиденциальностью
концепция: концепции
корень: корня
корневой: корневого корневом корневой корневым
который: которые которая которое которую котором которым который которой которому
крейт: крейтов крейты крейта крейте крейту крейтами крейт
куча: куче
лаконичный: Лаконичный
листинг: листингу листинге листинга Листинг
литерал: литерала
лично: лично
логика: логика
любой: любые
макрос: Макросы
мало: мало
менеджер: менеджеры
менее: менее
меньше: меньше
меняться: меняются
место: места место мест
метафора: метафору
метод: метода методы методам
мир: Мир
много: много
многопоточный: многопоточного многопоточный
моделировать: моделирует
моделироваться: моделируется
модуль: модулей модуля модуле модули модуль модулю модулях модулям модулем
модульность: модульности
модульный: модульной
можно: можно
мочь: могут может можем можете могли
мы: мы нам нас
мягкий: Мягкое
навигация: навигации
назвать: назвали
найти: найти
наконец: Наконец
наличие: наличии
написание: Написание
например: Например
нарушать: нарушая
настройка: Настройка
находить: находим
находиться: находится
начало: начале Начало начала
начать: начать начав
начинать: начинаем начинать
начинаться: начинающийся начинается начинаются начинающегося
наш: нашего нашу
небезопасный: Небезопасный
независимо: независимо
некоторый: некоторые
немного: немного
необременительный: необременительным
необходимый: необходимо
неправильный: неправильный
несколько: нескольких несколько
нет: нет
неустранимый: Неустранимые
нибыть: нибудь
новый: новой
нотация: нотацию
нужный: нужно
оба: оба
обеспечение: обеспечения
область: областью область области
обновить: обновить
обновление: обновления
обобщенные: Обобщённые
обозначение: обозначения
оболочка: оболочке
оборачивать: оборачивают
обработка: Обработка обработки
образ: образом
образец: образцом
обратите: Обратите
обращаться: обращаться
общедоступный: общедоступного общедоступным общедоступный общедоступными общедоступной общедоступном общедоступные общедоступных общедоступную
общий: Общие общим общий общему
объединение: объединения
объект: объектов
объектный: объектно
объявление: объявление
объяснить: объясним
обычный: обычными
один: одного одна один
однако: Однако
однопоточный: однопоточного
означать: означает
окружение: окружение
он: он него
они: их они
оператор: Операторы
описать: опишем
определение: Определение определения определением
определенный: определённой определённого определённую
определить: определена определены определён определено определили
определять: определяющий
определяя: Определяя
опровержимость: Опровержимость
организация: Организация организации
ориентировать: ориентированного ориентированных
освещать: освещали
основание: основании
особенность: особенность
оставаться: остаётся остаются
остальной: остальная
остаться: останется останутся
отдельно: отдельно
открывать: открывать
открытый: открытым
отличие: отличии
относительный: относительный относительные относительного относительным
отношение: отношениях
офис: офис
очень: очень
очистка: очистке очистка
ошибка: ошибок ошибки ошибках Ошибка ошибке ошибку
пакет: пакетов Пакеты пакет пакета пакетом
память: памяти
параллелизм: параллелизм
параллельный: параллельного
первый: первом первого
перевод: Переводы
передача: передачи
переменный: Переменные переменными
переместить: переместите переместим перемещён перемещены
перемещать: перемещать
перемещение: перемещения
пересылка: Пересылка
переупорядочение: переупорядочение
переход: перехода
перечисление: Перечисления перечислениям перечислений перечислениями перечисление
писать: писать
планировать: планируете
повар: повар
поведение: поведения
повод: поводу
подаваться: подаётся
подробнее: Подробнее
подробно: подробно
подсчет: подсчётом
подумать: подумайте
позволить: позволит
позволять: позволяет
пойти: пойти
пока: пока
показать: показать покажем показана показано
поле: поля поле полем полями
полезный: Полезные полезны
полностью: полностью
полный: полный
получать: получаем
получение: Получение
получить: получить получат получите
пользователь: пользователями пользователем пользователь
пользовательский: пользовательских
пометить: помеченный помечена помечены
помечать: помечаем
помещать: помещаете
помочь: поможет
помощь: помощью
понимание: Понимание
понять: понять
попробовать: попробуем
попробуйте: Попробуйте
поскольку: Поскольку
последний: последней последняя
последовательность: последовательности
последующий: последующих
построить: построить
поток: потока поток потоков потоками
потомок: потомками
потому: потому
похожий: похоже
почему: почему
поэтому: поэтому
правило: правилах Правила правилами правило правилу
правильный: правильные
практика: практики практику
превращение: Превращение
предисловие: Предисловие
предок: предках предков
предоставить: предоставить
предоставлять: предоставляемой
предпочитать: предпочитаем
представить: представить
прежний: прежним прежнему
приватность: приватности
приватный: приватные приватным приватными приватной приватное приватного
привести: привести
привет: Привет
приводить: приводит
приложение: Приложения
применяться: применяются
пример: Пример примеру
приносить: приносит
принять: примете
причина: причине
проблема: проблема
программа: программы
программирование: программирования Программирование
продвинуть: Продвинутые
продолжать: Продолжая
проект: проектами Проект проекта проекты проектам
проектирование: проектирования
производительность: производительности
произойти: произошло
происходить: происходит
простой: проще
профиль: профилей
публикация: Публикация
публичный: публичную
путь: Пути путей путь
работа: Работа работы
работать: работает
рабочий: Рабочие
равный: равно
раз: раз
раздел: разделе разделам
разделить: разделённых
разделять: разделяемого
разный: разных
разработать: разработать
разработка: Разработка разработки
разрешить: разрешён
рамка: рамки
раскрывать: Раскрываем
рассмотреть: рассмотрим
расти: растущими
расширение: Расширение
расширить: Расширенные
расширять: Расширяемый
реализация: Реализация реализации
редакция: Редакции
реорганизовать: реорганизовать
ресторан: ресторана ресторане
рефакторинг: Рефакторинг
решать: решает
решение: решением Решение
решить: решили решим
родитель: родителя родителем родитель
родительский: родительских родительском родительского родительскому
родственный: родственных
сам: само
самый: самое
сборка: сборке
свой: своё своих своей своему
связать: связанных связанными связано связан
сделать: сделать сделало сделав сделаем сделали
себя: себе
сезонный: сезонно
сервер: сервера сервер
символ: символы
синтаксис: Синтаксис
система: системе систему системы система
ситуация: ситуация
сказать: скажем
скомпилировать: скомпилировать
скомпилироваться: скомпилироваться
скоро: скоро
скорый: скорее
скрывать: скрывают скрывать
скрыть: скрыто
следовать: следуют
слово: слова словом слово словами
случай: случае случай
см: см
смочь: смогли
сначала: сначала
совместно: совместно
содержать: содержать содержащим
содержимое: содержимое
сожаление: сожалению
создавать: создаёт
создаваться: создаётся
создание: создание
создать: создать
соображение: соображений соображения
сообщение: сообщений Сообщения
соответствие: соответствии
соответствовать: соответствовать
сопоставление: сопоставление
сопровождать: сопровождают
сослаться: сослаться
составить: составим
состояние: состоянием
состоять: состоят
сочетать: сочетать
список: списков
способ: способа
спросить: спросить
сравнение: Сравнение
среда: среды
срез: среза
срок: сроков
ссылаться: ссылаться
ссылка: ссылки ссылок ссылками
ссылочные: Ссылочные
становиться: становится
строка: строками строки
структура: структур структуры структурой структуру структурам структурами Структура структуре
так: так
также: также
такой: такое такой таким такая
там: там
текст: текста
текущий: текущего текущем
тема: тема
теперь: Теперь
тесно: тесно
тест: тестов тесты
тестирование: тестирование
тип: Типы Тип типов
типаж: типажи
тогда: Тогда
тоже: тоже
тот: то том того тем тех
точечный: точечную
точно: точно
трейт: трейта трейтов трейт
трейты: трейты
убрать: убрать
увидеть: увидеть
удалив: удалив
указание: указания
указатель: указатели указателями указатель
указать: указать указано
указывать: указываем указывать указывая
улучшение: улучшения Улучшение
умный: Умные умными умный
умолчание: умолчанию
упоминать: упоминали
управление: управления Управление
управлять: Управляющие управляют
упростить: упростили упростить
уровень: уровне
успех: Успех
установить: установить
установка: Установка
устранимые: Устранимые
утечка: утечке
файл: файла файлов Файл
файловый: файловой файловую
финальный: Финальный
фрукт: фрукты
функциональность: функциональности
функциональный: Функциональные
функционировать: функционировать
функция: Функции функцию Функция функциям
характеристика: характеристики
хлеб: хлеба
хороший: Лучшие хороший
хотеть: хотим хотите
хотя: Хотя
хранение: Хранение
цикл: циклы
часто: часто
часть: частью части часть
человек: людей
читать: читать
чтение: Чтение
что: чего Что
шаблон: шаблона Шаблоны шаблон шаблоном
шаг: шага
шеф: шеф
эквивалентный: эквивалентной
экземпляр: экземпляров экземпляр
элемент: элемент элементов элемента элементы
это: это этого
этот: Эти этому этот этой эта эту этом
являться: является являются
язык: Язык языка языков
