беспокоиться: беспокоиться
блок: блока
более: более
бывать: бывают
быть: будут быть будет было
весь: весь
ветка: ветки веткой
вместе: вместе
возможность: Возможность возможности
возможный: возможному возможного
время: время
всегда: всегда
вы: вам вы
выдавать: выдаёт
выдать: выдаст
выполнение: выполнение
выполнять: выполнять
выражение: выражении выражения выражений
где: где
давать: Давайте
дать: даст
два: двух
должный: должны должен
допустимый: допустимое
его: его
жаловаться: жаловаться жалуется
зависимость: зависимости
заключаться: заключается
заменить: заменён
затем: Затем
знать: знаете
значение: значению значение значения значением
значимый: значимого
изменить: изменить
иметь: имеет
инструкция: инструкции инструкция инструкцией
исключение: исключением
использование: использования Использование
использовать: используете использовать использующий используем
исправить: исправить исправлен
каждый: каждое
код: код кода
компилироваться: компилироваться
компилятор: компилятор
компиляция: компиляции
конструкция: конструкцию
концепция: концепцией
корректный: корректного корректное корректный
который: которые которой который которого
листинг: листинге Листинг листинга
любой: любому любые
менее: менее
можно: можно
мочь: может могут могли можем
мы: мы нам
наличие: наличия
наоборот: наоборот
некоторый: некоторому
необходимый: необходимо
неопровержимый: неопровержимые неопровержимыми неопровержимых неопровержимый неопровержимым
нет: нет
неудача: неудачи
ничто: ничего
нужный: нужно нужен
обработка: обработки
образец: образца образец образцом
общий: общем
один: одной
ожидать: ожидать
ознакомиться: ознакомиться
означать: означает
она: неё
они: они
оно: оно
определение: определению
опровергнуть: опровергнуть опровергнутыми
опровержение: опровержения
опровержимый: опровержимые опровержимыми опровержимый опровержимым опровержимого
особенно: особенно
остаться: оставшиеся
отреагировать: отреагировать
ошибка: ошибке ошибку ошибки
параметр: Параметры
передать: переданному
переменный: переменной
поведение: поведения
позволять: позволяет
показать: показана показано показанного
покрыть: покрыли покрыть
полезный: полезен
получение: получения
помощь: помощью
попытка: Попытка
последний: последнего
посмотреть: посмотрим
потому: потому
потребоваться: потребуется
предназначить: предназначены
предостерегать: предостерегает
предполагать: предполагаемого
предупреждение: предупреждение
пример: Примером пример примера
принимать: принимать принимают
причина: причине
проблема: проблему
программа: программа
продолжить: продолжить
происходить: происходит
пропустить: пропущено
простой: простой
пытаться: пытаемся пытались
равный: равно
разница: разнице разницу
разный: разный
рассмотреть: рассмотрим
сбой: сбоя
сделать: сделать
синтаксис: синтаксис
скобка: скобок
следовательно: следовательно
следовать: следовало
случай: случае случаях
смысл: смысла
совершенно: совершенно
совпадать: совпадать совпадают совпадает совпадающие
создание: создания
сообщение: сообщении
соответствовать: соответствовать соответствует соответствовало
сопоставлять: сопоставлять
способность: способности
такой: таких
там: там
теперь: Теперь
тот: то тем того
требовать: требует
требоваться: требуется
увидеть: увидев
указать: указали
условный: условного
успех: успеха
фигурный: фигурных
форма: форм
функциональность: функциональность
функция: функций
цикл: циклы
что: что чему
шаблон: шаблон Шаблоны шаблонов шаблонами шаблоном шаблону шаблона
это: это
этот: этот этой
являться: являются являющийся является
