автоматически: автоматически
анализатор: анализатор
безбоязненно: безбоязненно
безопасно: безопасно
безопасность: безопасности
безопасный: безопасной
библиотека: библиотеки библиотекой библиотека
более: более
больше: больше
быстрый: быстрее
быть: были есть быть будет
важный: важная
вариант: варианты
ваш: Ваши ваших
весь: все
вид: виде
видеть: видели
включать: включает
владение: владение
возможно: возможно
возможность: возможностей возможности
вперед: вперёд
время: время
вручную: вручную
встроить: встроены
вы: Вы
выполнение: выполнения
гарантировать: гарантируют
гарантия: гарантии гарантиях
глава: главе главы
говорить: говорили
гонка: гонки
далее: Далее
данные: данных
данный: данный
два: две
делать: делает
должный: должны
доступ: доступа
другой: другими другой других
заимствование: заимствования заимствований
заключаться: заключается
здесь: здесь
знакомый: знакомы
значение: значение
идиома: идиомы
идиоматичный: идиоматичных
идти: иди
иметь: имеет
инвариант: инвариантов
интересно: Интересно
интернет: Интернете
информация: информация информации
исключение: исключения
использование: использования использование использовании
использовать: использовать использующий
использоваться: использоваться
итог: Итоги
каждый: каждый
канал: каналы
клон: клоном
клонировать: клонировали
книга: книге
код: код кода
компилироваться: компилирующийся
контекст: контекстах
концепция: концепции концепцией
который: которых который которые которым котором которую которыми
крейт: крейтов крейты
кроме: Кроме
листинг: листинге
любой: Любой
мало: мало
маркерный: Маркерный маркерными
менее: менее
мера: мере
метод: методов
многий: многие
многопоточность: многопоточность многопоточности многопоточностью
многопоточный: многопоточный многопоточных Многопоточное многопоточными
моделирование: моделирования
можно: можно
момент: момент
мочь: можете может могут
мы: мы
написать: написать написанные
небезопасный: небезопасно небезопасна небезопасного
небольшой: небольшие
недействительный: недействительные
некоторый: некоторые
необходимый: необходимо
несколько: нескольких несколькими
нет: нет
никакой: никаких
никогда: никогда
новый: новых
оба: оба
обнаружить: обнаружить
обновить: обновить
обсудить: обсудим
обсуждать: обсуждаемые
объектный: объектно
обязательно: обязательно
ограничение: ограничений
ограничиваться: ограничиваются
одновременно: одновременно
однопоточный: однопоточных
означать: означает
он: он
они: них Они их
опасаться: опасаться
ориентированный: ориентированному
отправить: отправить
отправлять: отправлять
очень: очень
ошибка: ошибку ошибок
передаваться: передаваться
передать: передать
передача: передачи
переключиться: переключились
платить: платить
поговорить: поговорим
подобный: Подобно
поискать: поищите
полезный: полезны
полностью: полностью
получить: получили Получив
помечаться: помечается
помощь: помощью
попытаться: попытались
поскольку: Поскольку
последний: последний
поток: потоками поток потока потоков потоках
потому: потому
поточный: поточно
почти: Почти
поэтому: поэтому
предоставлять: предоставляет
пример: примеры
примитивный: примитивные
причина: причине причинам
проблема: проблем
проверка: проверки
программа: программы программ
программирование: программирование программированию
продумать: продумать
проект: проект
производительность: производительности
работа: работы
работать: работать
развиваться: развиваются
раздел: разделе
разрешение: Разрешение
ранее: ранее
расширить: Расширенная
реализация: Реализация реализации реализацию
реализовать: реализующим реализован реализующий реализованы
реализовывать: реализовывать
реалистичный: реалистичного
решение: решения решений
ручной: Ручная
сам: сам
свой: свой свои
связать: связанных связаны
сделать: сделать сделай
себя: себя
семейство: семейство
система: система
ситуация: ситуациях
скомбинировать: скомбинированные
скомпилироваться: скомпилировался
следовательно: Следовательно
слово: словами
случай: случай случая
случайно: случайно
смочь: сможете
снижение: снижение
соблюдать: соблюдать
собственный: собственный
совместный: совместного Совместное
современный: современные
содержать: содержать
создание: создания
создать: созданные
сообщение: сообщений
состоять: состоящий состоящих
способ: способах
ссылаться: ссылаться
ссылка: ссылок ссылка ссылку ссылки
стандартный: стандартной стандартная
стоить: стоит
структурирование: структурирования
счетчик: счётчик
сырой: сырых
также: также
такой: такие
текущий: текущие
тип: типом тип типов типы типами
типаж: типажей типажи типаж типажа типажами
тот: Тем том того теми
трудный: трудно
тщательно: тщательно
уверить: уверены
увидеть: увидите
уже: уже
указатель: указателей указатель
указывать: указывает
умный: Умный умных
упоминаться: упоминалось
управлять: управлять
усложнение: усложнения
успешно: успешно
функционал: функционал
функция: функции
хотеть: хотите
часть: частью частей
что: что чего
это: это
этот: этой эти этих
являться: является являются
являясь: Являясь
язык: язык языка языком языке языках
