аналогичный: аналогичным
аргумент: аргумента
артефакт: артефакты
библиотека: библиотеки библиотек библиотека библиотеку
библиотечный: библиотечный библиотечных библиотечного
бинарный: бинарный бинарным
больше: больше
большой: большой
быть: будет будем будут было
ваш: вашего ваш
ввести: ввести
версия: версию версии
верхний: верхнем верхнего верхней
весь: всего все всех
взаимосвязанный: взаимосвязанными
видимость: видимости
включать: включал
внесите: Внесите
внешний: внешних
внимание: внимание
возможность: возможность
возникнуть: возникнуть
всегда: всегда
второй: вторая второго
вы: вы
вывод: вывода
выглядеть: выглядеть
вызов: вызова
выполнение: выполнение
выходной: выходные
гарантировать: гарантирует гарантируя
где: где
глава: главе
давать: Давайте
далее: Далее
данные: данные
данный: данном данное
два: две двух
двоичный: двоичный
делать: делали
директория: директорию
добавить: добавить добавим добавьте добавлен
добавление: Добавление
документация: документации
должный: должны должен
дополнительный: дополнительных дополнительной
друг: друг друга другом
другой: других
единственный: единственный
единый: единого
еще: ещё
зависеть: зависеть зависел зависит
зависимость: зависимость зависимости зависимостей зависимостью
загрузить: загрузит загружено
записать: запишет
запуск: Запуск
запускать: запускает
запустите: запустите
запустить: запустив запустим запустить запустит
заставить: заставить
затем: Затем
захотеть: захотите
избежать: избежать
изменение: изменения
изменить: измените
изменяться: изменяются
иметь: имеет имел иметь
имя: именем имени имя
информация: информацию
исполняемый: исполняемый исполняемым
использование: использованием использованию Использование использования
использовать: используют использовать используем использован использующих использовали используя
исправить: исправить
исходить: исходит
каждый: каждый каждому каждого
какой: какой
каталог: каталога каталоге каталог каталоги
качество: качестве
код: код кода
команда: команду команде
компиляция: компиляции
компонент: компоненты
конкретный: конкретного конкретный
конфигурация: конфигурацию
координация: координацию
копия: копий
который: который которая которые которого
крейт: крейты крейт крейтов крейта крейтом крейту крейте крейтах крейтами
кусок: кусок
легче: легче
листинг: листинге Листинг
менее: менее
мера: мере
место: место
модуль: модули
мочь: может можем могут могли
мы: мы нас нам
набор: набор
название: названием названия
назвать: назовём
найти: найдено
например: Например
начать: Начнём
начинаться: начинаться
наш: нашим нашу нашей
небольшой: небольшие
ненужный: ненужной
необходимый: необходимо
несколько: несколько несколькими
никакой: никаких
новый: новый
нужный: нужно
оба: оба
обеспечивать: обеспечивает
область: область области областей
облегчить: облегчить
обнаружить: обнаружено
образ: образом
обратите: Обратите
один: один Одна одного одну одной одни
означать: означать
оказаться: окажутся
окружение: окружения
он: он его
она: её
они: них их они
определить: определил
определять: определять
опубликовать: опубликовать
основный: основную
отдельно: отдельно
отдельный: отдельные
откройте: Откройте
отношение: отношения
отредактируйте: отредактируйте
ошибка: ошибку
пакет: пакет пакетами пакетов пакету пакета пакетах
параллельно: параллельно
первый: Первая
перекомпилировать: перекомпилировать
перекомпиляция: перекомпиляции
подобный: Подобно
позаботиться: позаботился
позволить: позволит
пока: пока
показать: покажем показано
показывать: показывает показывают
получить: получим
поместить: помещены поместить
помогать: помогает
помощь: помощью
понять: понять
последний: последняя
потому: потому
поэтому: поэтому
практика: практики
предоставить: предоставит
предоставлять: предоставляет
прийтись: пришлось
проект: проекта проект
пройти: прошёл
пространство: пространства пространство пространстве
путь: путь пути
рабочий: Рабочие рабочего рабочую рабочая рабочее рабочем рабочей рабочих
равный: равно
развитие: развития
раздел: раздел
разделить: разделить
разрабатываться: разрабатываются
рассмотреть: рассмотрите
результат: результатов
рост: роста
сборка: сборку сборке
свести: сведёт
свой: свой
сгенерировать: сгенерируйте
сделать: сделать
себя: себя
секция: секции секция
ситуация: ситуация
скомпилировать: скомпилированные скомпилирует
следующий: следующим следующие Следующая
случай: случае
смотреть: смотря
сначала: Сначала
собрать: соберём
собраться: соберётесь
собственный: собственного собственный
совместимый: совместимы
совместный: совместному
содержать: содержащая содержит содержащего
создание: Создание создания
создать: создали создадим создать
сосредоточиться: сосредоточиться
список: списке список
способ: способов способом
становиться: становиться
строка: строку
структура: структуре
структурировать: структурировать структурированном
существовать: Существует
так: так
также: также
тандем: тандеме
тема: Тем
теперь: теперь
тест: теста тест тесты
тот: тот того ту те то том
три: три
тривиальный: тривиальный
указание: указанием
указать: указав указать укажите
улучшение: улучшения
управлять: управлять
уровень: уровне уровня
участник: участника
файл: файл файле Файлы файлом
флаг: флага флаг
функционал: функционала
функциональность: функциональность
функция: функцию функции
хотеть: хотим
хранение: хранения хранение
часто: часто
часть: частью части
что: что
экономить: экономя
этап: этапе
это: это этого этому
этот: Эти этом этот
являться: является
явно: явно
