абсолютно: абсолютно
аварийно: аварийно
аварийный: аварийным аварийному аварийного
автоматический: автоматические
адрес: адресом
альтернативный: Альтернативная
анализатор: анализатор
аналогично: аналогично
аналогичный: аналогичным
аргумент: аргумента аргумент
асинхронный: асинхронного асинхронно
ассоциированный: ассоциированную
атака: атак
беззнаковый: беззнаковый
безопасный: безопасный
бесконечный: бесконечном
библиотека: библиотеках библиотеку библиотеки библиотека библиотеке
библиотечный: библиотечный библиотечного
бинарный: бинарного
блок: блоком блока
блокировать: блокирующий
блокировка: блокировки блокировку блокировкой блокировка
более: более
больше: больше
больший: больших
бороться: бороться
брать: берёт
браузер: браузера браузере браузеры
быстро: быстро
быть: есть было быть будет будут был будем будете были
важный: важным
вариант: вариантами вариантов
ваш: вашего
ввести: введёте
ввод: ввода
веб: веб
вектор: вектор вектора векторе
верно: верно
вернуть: вернуть вернули
вероятно: вероятно
весь: все всех всё всего
ветка: ветка
видеть: видели
видимость: видимости
вкладка: вкладках
включать: включает
включить: включили
владение: владением владение
владеть: владеть
внесите: Внесите
внести: внести внесли внесём
внешний: Внешний
внимание: внимание
внимательно: внимательно
вновь: вновь
внутри: внутри
внутрь: внутрь
возвратить: возвратить
возвращать: возвращать возвращаемому возвращает возвращаемого возвращала
возвращаться: возвращается
возможность: возможность
возможный: возможно возможных
возникать: возникает
возникнуть: возникнет возникнуть
воспользоваться: воспользуемся
вот: Вот
вполне: вполне
временной: временные
время: времени время
вручную: вручную
всегда: всегда
вспомните: Вспомните
вставка: вставки
второй: второе Вторая
входить: входящих входящего
вы: вы вам вас
выбирать: выбираем
выбрать: выбрали
вывод: вывода
выглядеть: выглядеть выглядит
выделение: выделение
выделять: выделяет
вызвать: вызвать
вызов: вызов вызова
вызывать: вызывать вызывает вызываем
вызывающий: вызывающий
выполнение: выполнение выполнения выполнением
выполните: Выполните
выполнить: выполнить
выполнять: выполнять выполняет выполняя выполняют
выполняться: выполняться
выражение: выражении
высказывание: высказывание
гарантировать: гарантирует
где: где
генерация: генерации
гипотетический: гипотетический
глава: главы главе
глядеть: глядя
говорить: говорит
гонка: гонки
гораздо: гораздо
готовый: готовых готовы
группа: группой
давать: давайте даёт
далее: далее
далекий: дальше
дальнейший: дальнейшем
данные: данных
данный: данной данном данный
два: два двумя двух
действие: действии действий
действительно: действительно
делать: делает делаем делали делают делать
делиться: делиться
дело: деле
дизайн: дизайне
длинный: длинных длинные
длительный: длительного длительный
добавить: добавив добавим добавили
добавление: добавления
документация: Документация документации
документирование: документирования
долгий: дольше
должный: должно должны должен должна
дополнительный: Дополнительную
допустимый: допустимое
достаточно: достаточно
доступ: доступ
доступный: доступны
другой: другие другое других Другими другой другом
единичный: единичный единичным
единожды: единожды
единый: единый
емкость: ёмкостью
еще: ещё
ждать: ждать
ждет: ждёт
желаемый: желаемое желаемого
жизнь: жизни
завершать: завершает
завершаться: завершаться
завершение: завершения завершениям завершению
завершить: завершит завершить
завершиться: завершиться завершится завершился
зависеть: зависеть
загружаться: загружаться
загрузить: загрузите
загрузка: загрузкой
задание: заданий задание задания
задать: заданный
задача: задачу задача задач задачи задаче
задержаться: задержаться
задержка: задержки
заимствование: заимствований
заказ: заказы заказов
заключаться: заключается
закончить: законченный закончили
заменить: заменить
заметить: заметить
замечательно: Замечательно
замыкание: замыкания замыкание замыканий замыканием замыкании
занимать: занимает
занять: занят
запрашивать: запрашивать запрашивая
запрос: запрос запросов запросам запроса запросы запросу
запросить: запросить запросите
запуск: запуска
запускать: запускает
запускаться: запускается
запустите: Запустите
запустить: запустит запустить
заранее: заранее
заснуть: заснёт
заставить: заставить заставим
заставлять: заставлять
затем: Затем
захват: Захват
захватить: захваченных
захотеть: захотите
защитить: защитить
звучать: звучит
здесь: здесь
знак: знака
знакомый: знакомым
знать: знаем знать знает
значение: значений значению значения значение
идеально: идеально
идеальный: идеальный
идентификатор: идентификатора
избавиться: избавиться
извлекать: извлекать извлекали
изменение: изменения изменений Изменение изменениями
изменить: изменить изменили Изменим
изменять: изменять
изучение: изучения
изучить: изучили
иметь: иметь имеет имея
имитация: Имитация
имя: именем имя
инициализировали: инициализировали
инструкция: инструкции
интервал: интервалами
интересный: интересна интересен
интересовать: интересует
интерфейс: интерфейс
информация: информации информацию
использование: использование использования использованием использовании
использовать: использовать использовали использующем используем использует используя использующий используемые
исправить: исправить
итак: Итак
итог: итоге
каждый: каждый каждого каждому каждое
казаться: кажется
какой: какой каких какие какое
канал: каналы канал канала
касающиеся: касающиеся
качество: качестве
клиент: клиентов
клиентский: клиентский
кликнуть: кликнуть
клонировать: клонировать клонируем
когда: Когда
код: код кода коде
количество: количества количество
коллекция: коллекции
команда: командой команды команду команда
комментарий: комментариев комментарий
коммуникация: коммуникации
компилировать: компилируемым
компилироваться: компилируется
компилятор: компилятором компилятора компилятор компиляторами
компиляция: компиляции
конец: конец конца
конечный: конечного конечном
контролировать: контролирующий
конфигурировать: конфигурируемым
короче: короче
корректный: корректного
который: которого которой которые который которую которое которая котором которыми которому
крейт: крейт крейта
кто: кто
кухня: кухне
кэширование: кэширования
легче: легче
листинг: листинге Листинг листинга
литерал: литералами
логирование: логировании
любой: любых любой любого любые
макрос: макрос макроса
медленный: медленного медленной медленный
менее: менее
мера: мере
место: места
метод: метод метода методе методом
миллион: миллионов
миновать: миновать
многий: многих
много: много
многопоточный: многопоточный многопоточного
многословный: многословно
множество: множества
модель: модель
модификация: Модификация
модуль: модуль
модульный: модульные
можно: Можно
момент: момент
мочь: могут может мог можем можете могли
мы: Нам Мы нас нами
мьютекс: мьютекс
мьютекса: мьютекса
название: названии название
назвать: назовём
назначать: назначает
называться: называется
накладывать: накладывает
наконец: наконец
написать: написать Напишите напишем написали
например: например
насколько: насколько
находиться: находится
начало: начало начале начала
начать: начнёт начать начнём
наш: наш наша нашего нашей нашу нашем наших наши наше
небольшой: небольшим небольших
некоторый: некоторый некоторые
нельзя: нельзя
немедленно: немедленно
немного: немного
необходимый: необходимо необходимый необходим
неограниченный: неограниченного неограниченном
непоправимый: непоправимой
непосредственный: непосредственного
несколько: несколько нескольким несколькими нескольких
нести: несут
нет: нет
неудача: неудачей
нехватка: нехватки
низкий: ниже
низкоуровневый: низкоуровневым
никакой: никакого
никогда: Никогда
ничто: ничего
но: Но
новый: новые новую новой новый нового новом новым новая
ноль: ноль
номер: номер
нужный: нужно нужные нужен нужны нужным
нулем: нулём
нуль: нуля нулю
область: область
облегчать: облегчая
обобщенный: обобщённый
обрабатывать: обрабатывает обрабатывать обрабатываем обрабатывая
обрабатываться: обрабатывалось
обработать: обработаны обработана обработать
обработка: обработку обработка обработки обработкой
обработчик: обработчиков
образ: образом
обратить: обратить обратите
обратиться: обратитесь
обслуживание: обслуживании обслуживания
обслуживать: обслуживать
обсуждаться: обсуждалось обсуждались
общедоступный: общедоступный
общепринятый: общепринятое
объект: объекта
объем: объём
обязательно: обязательно
ограничение: ограничений ограничения ограничение ограничениями
ограничить: ограничим
один: одно одного одному один одним
однако: Однако
одновременно: одновременно
однопоточный: однопоточного
ожидать: ожидающих ожидает ожидать ожидают
означать: означает
окно: окна окнах
окончательный: окончательной
он: он его
она: она её
они: их им они
оно: оно
операционный: операционная
описать: описано
оправдать: оправдано
опрашивать: опрашивать
определение: определением определении определение
определить: определить определим
оптимальный: оптимальным
опустить: опущен
опять: Опять
основать: основано
оставить: оставили
остальной: Остальные
остановить: остановить остановим
осуществить: осуществим
осуществляться: осуществлялось
ответ: ответа
ответить: ответить ответит
ответственность: ответственность
ответственный: ответственная
отвечать: отвечает
отдать: отдать
отдельный: отдельную
отказ: отказ
открыть: откройте
отладка: отладке
отличие: отличием
относиться: относится
отправитель: отправитель
отправить: отправит отправить отправим
отправка: отправку Отправка
отправлять: отправлять отправляли отправляющую отправляющей отправляем отправляет отправляющее отправляющий
отправляться: отправляться
отправной: отправной отправная
отработать: отработает
отравить: отравленном
отредактировать: отредактируйте
отрицательный: отрицательное отрицательным
охранять: охраняемому
очередь: очереди очередь
ошибка: ошибки ошибками ошибка ошибку ошибкой ошибках ошибке
память: памяти
паниковать: паниковать
параллельно: параллельно
параметр: параметр параметра параметров параметрами
первый: первого Первая первый
перегрузить: перегружена
передавать: передавал передавала передаём передавать
передать: передадим переданное переданные передать
передача: передачи Передача
переделать: переделаем
переключение: переключение
переключиться: переключились переключимся
перемещение: Перемещение
писать: писать
план: План
планировать: планируем
поведение: поведение поведением поведения
повлиять: повлиять
повод: поводу
поговорить: поговорим
подбираться: подбираемся
подобный: Подобно
подойти: подойдут
подробность: подробности
подтормаживание: подтормаживания
подумать: подумаем
подход: подход подхода
подходящий: подходящей
позволить: позволит
позволять: позволяет позволяют
поздний: позже
познакомиться: познакомились
пока: пока
показать: показаны показан показано показанные
показывать: показывает
поле: поля
полезный: полезны
полный: полные
получатель: получателем получателя получатель
получать: получает получаем получающую получать
получение: получения Получение
получить: получен получить полученный получит полученным получили
помещать: помещаем
помнить: помнить
помочь: помог
помощь: помощью
попробовать: попробовать попробуете попробуем
попробуйте: Попробуйте
попытаться: попытается
попытка: попытка попытке
пора: пор
породить: порождённых порождённый
порождать: порождать порождаемым
порождение: порождения Порождение порождении
поскольку: Поскольку
последний: Последний
последовательно: последовательно
последовательность: последовательность
последовательный: последовательное
последующий: последующим последующие
посмотреть: посмотрим посмотреть
посмотрите: Посмотрите
постараться: постараемся
поступать: поступающих Поступающие
поступить: поступят
поступление: поступления
посылать: посылаем
потенциально: потенциально
поток: потоков потоком потоки поток потока потоке потоку потоками потокам
потому: потому
потребитель: потребитель потребителям
похожий: похожий похожее
почему: почему
почитать: почитать
поэтому: поэтому
появиться: появится
правило: правила
практика: практикам
превращение: Превращение
предварительный: предварительное
предназначить: предназначен
предоставлять: предоставляет
предполагаться: предполагалось
представлять: представляет
представьте: Представьте
предупреждение: предупреждения
прежде: прежде
прежний: прежнему
прекратить: прекратила прекратил
преобразовать: преобразовать
приватными: приватными
привести: приведёт
приемник: приёмник приёмника
прийтись: придётся
применение: применением
применять: применять
примечание: Примечание
примитивен: примитивен
принимать: принимает принимал принимать принимала принимающий принимающую принимающей принимаемый принимающая
принятие: принятие
принять: принять принято
присвоить: присвоим
приступить: приступить
приходиться: приходится
причем: причём
причина: Причина
проблема: проблему проблем проблема
проверить: проверим проверить
проверка: проверки Проверка
проверять: проверять
программа: программа программу
проект: проекте проект проекта
проектировать: проектировать
производитель: производителей
производительность: производительности
произойти: произойдёт произойти
происходить: происходить
промежуточный: промежуточные
пропускной: пропускной пропускную
проследить: проследить
простой: простейшим простейшую простая простой простых
простота: простоты
противный: противном
псевдоним: псевдоним псевдонимов псевдонимы псевдонима
публичный: публичного
пул: пулом пула Пул пуле пулу пулов
пустой: пустым
пытаться: пытаетесь пытаемся пытается
работа: работу работы работой
работать: работать работал работает работающих работало
работник: работник работники работнику работника работником работникам работниках работнике
рабочий: рабочего рабочем
равенство: равенства
равный: равно равен
раз: раз
раздел: разделе раздел раздела
разделять: разделять
различать: различать
различный: различными
размер: размер
разница: разницу
разный: разных
разобраться: разберёмся
разрабатывать: разрабатывать
разработка: разработку разработки разработкой
разрешать: разрешать
разыменование: разыменования
ранее: ранее
ранний: раньше
распознавание: распознавание
рассмотреть: рассмотрим
реализация: реализации реализация реализацию
реализовать: реализована реализуем реализовать
реализовывать: реализовывать
реализуйте: реализуйте
реальный: реальных реальный реальной
ресторан: ресторана
ресурс: ресурсу ресурсы ресурсов ресурса
решение: решениях решениями
решить: решили решить
рост: росте
сам: сами самом
самостоятельно: самостоятельно
самый: самая
сбой: сбой
свободный: свободных свободному
свой: своей своём свой
связать: связано связанного
сгенерировать: сгенерированная
сделать: сделанные сделавший сделаем сделать сделаете сделали сделайте
себя: себе
сейчас: сейчас
секунда: секунд
секундный: секундной
сервер: сервера сервер серверу
сигнатура: сигнатура сигнатуре сигнатурой сигнатуру
сильный: сильному
синоним: синонимов
система: системы система
системный: системных
ситуация: ситуация ситуации ситуацию
скобки: скобки
сколько: сколько
скомпилироваться: скомпилируется
следовать: следовали
следующий: следующий следующую следующее следующими следующим Следующая
случай: случая случае случай
слышать: слышали
смочь: сможем сможет
смысл: смысле смысла
сначала: сначала
снижение: снижению
сниматься: снимается
снова: снова
снятие: снятия
совместный: Совместное
совпадать: совпадает
совпадение: совпадения
содержать: содержит содержал содержащий содержать содержащего
содержаться: содержится
соединение: соединение соединения
создавать: создавала создавал создавать создавали создаёт создаём
создаваться: создаются создаётся
создание: Создание создания создании
создать: создать создаст создадим Создайте создан созданы созданные
сообщение: сообщение сообщений сообщения сообщением
соответствовать: соответствует
сопоставить: сопоставить
состояние: состоянии
сохранить: сохраним
сохранять: сохранять сохраняем сохраняет
специально: специально
список: список
способ: способов способ способа
способность: способности способность
справа: справа
сработать: сработает
сравнение: сравнения
срез: срез
ссылаться: ссылаться ссылается
ссылка: ссылки ссылок
стандартный: стандартной Стандартная
стесняться: стесняйтесь
стоить: стоило
сторона: сторону стороны стороной сторона
страница: страницу страницы
стремление: стремление
строгий: строгими
строковый: строковыми
структура: структуры структуре структуру Структура
структурировать: структурирован
существовать: существующий существует
сценарий: сценария
счет: счёте
счетчик: счётчик
считать: считать
так: так
также: также
таков: таков
такой: такое таком таким таких
там: там
текущий: текущей текущую текущий
тело: тела
тема: тема
теперь: теперь
тест: тесты
тестирование: тестирование
техника: технику
течение: течение
тип: тип типа типы типом типов
типаж: типажами типажа типаж
тогда: тогда
тоньше: тоньше
тот: то тем том тому того тот ту тех
точка: точки точка
требование: требованиям
требовать: требовало
трейт: трейты
третий: Третья
три: три тремя
увеличивать: увеличивая
увеличиваться: увеличиваться
увеличить: увеличили увеличить
уверенность: уверенность
увидеть: увидеть увидите
удаление: удаление
удалять: удаляет
удаться: удастся
удержание: удержания
удерживать: удерживая удерживаем
удерживаться: удерживаться
удивиться: удивиться
удостовериться: удостовериться
уже: уже
указание: указания
указатель: указатели указателя
указать: указанные указали
указывать: указывает
указываться: указывается
улучшение: Улучшение
улучшить: улучшить улучшим
умный: умные
уничтожаться: уничтожаются
упоминать: упоминали
упоминаться: упоминалось
управление: управления
управляемый: управляемую управляемой
управлять: управлять
условие: условия
успех: Успех
успешно: успешно
успешный: успешную
установить: установили
устраивать: устраивает
устранить: устранить
учитывать: учитывать
файл: Файл
факт: факт
фиксированный: фиксированное
функционал: функционал
функциональность: функциональность
функционировать: функционировать
функция: функции функция функцию функций функцией
хаос: хаос
характеристика: характеристики
хороший: хороший хорошим
хотеть: хотите хотим хочет
хранение: хранения
хранить: хранить
храниться: хранящейся
целиком: целиком
целочисленные: Целочисленные
цель: цели
цикл: цикла цикле цикл
циклически: циклически
цифровой: цифрового
часть: части часть
человек: людей
четыре: четырьмя четырёх
число: числа число числом числе
что: что чего
чувствовать: чувствуете
шаблон: шаблона
экземпляр: экземпляр экземпляров экземпляры экземплярам экземпляре экземпляра
элемент: элементов элемента
эмуляция: эмуляцией
это: это
этот: эти этот эту этим этой эта этих этими этом этого
эффективный: эффективным
являться: является являются
явно: явно
язык: языком языках
