абстракция: абстракцией абстракций абстракции
автоматический: автоматических
адаптер: адаптера
алгоритм: Алгоритм
аналогичный: Аналогично
анонимный: анонимные
аргумент: аргументов
ассемблерный: ассемблерный
аудио: аудио
безбоязненный: Безбоязненный
библиотека: библиотеки
билд: билдов
бинарный: бинарных
бита: биты
близкий: близки
более: более
большой: большого
будущий: будущих
быстрый: быстрее быстрый
быть: была будем будучи будет
бьерн: Бьёрн
валидация: Валидация
вариант: варианты вариант
введение: Введение
ввод: вводом
вдохновить: вдохновлённые
веб: веб
вектор: векторами
версия: версия
весь: Все всё
взять: взятый
вид: виде
видимость: видимости
владение: владения владение
влияние: влияния
вместо: вместо
внутренний: внутренняя
возможность: возможности возможностей
впоследствии: впоследствии
вправо: вправо
время: время
всевозможный: всевозможные
вы: вам вы
выборка: выборок
вывод: выводом
выводимые: Выводимые
вызов: вызовов
выполнение: выполнением Выполнение выполнения
выполнить: выполнили
выпуск: выпуска
выражать: выражать
высокий: высокого
высокоуровневый: высокоуровневой высокоуровневом
вычисление: вычислений
вычислить: вычислить
где: где
генерировать: генерирует
глава: главы
граница: границ
далее: далее
данные: Данных данные
два: две два
двенадцать: двенадцать
действие: действия
декодер: декодера декодеры
декодирование: декодирования
делать: делают
дело: Дело
дерево: дереве
дизайнер: дизайнер
длина: длины
добавление: добавления
доказать: доказать
дополнительный: дополнительных
допускать: допускающих
доступ: доступ доступа
другой: другие другого
еще: ещё
жизнь: жизни
завершение: завершение
загадка: загадки
заимствование: заимствование
закодировать: закодированного
замыкание: замыкания
замыканий: замыканий
запись: Запись
затем: Затем
захватывать: захватывают
здесь: здесь
знать: знать знает знаете
значение: значений значениями значения значение значениям
игра: игры
идея: идея идеи идеями
издержка: издержки
изменяемость: изменяемость
иметь: имеют имеет
инструмент: инструменты
использование: Использование использованием
использовать: использующей использовать используете использует используя используйте
использоваться: использоваться
исчерпывающий: исчерпывающего
итератор: итераторы итераторов итераторами итератора итератор
итерация: итерации итераций
итог: Итоги
каждый: каждое каждой
какой: какая какой
качество: качестве
ключ: ключей
ключевой: ключевого Ключевые
книга: книги книге
код: кода код
коллекция: коллекции
команда: команд
командный: командной
комбинирование: комбинирование
комментарий: Комментарии
компилироваться: компилироваться компилируется
компилируются: компилируются
конструкция: конструкции Конструкция
контекст: контекста
конфиденциальность: конфиденциальностью
концепция: концепции
который: которые которой которая
коэффициент: коэффициентов коэффициентах коэффициенты
краткий: кратким
крейт: крейтов крейты крейта
куча: куче
лаконичный: Лаконичный
линейный: линейного линейной
лучше: лучше
макрос: Макросы
массив: массив массиву
математический: математическую математических
место: места
метод: метода метод
мир: Мир
многопоточный: многопоточного многопоточный
модуль: модулей
модульность: модульности
момент: момент
мочь: могут может
мы: Мы нам
мягкий: Мягкое
накладный: накладные накладных
накладывать: накладывает
написание: Написание написания
написать: написали
направить: направленных
настройка: Настройка
начальный: начальных
начать: начать
наш: нашего нашем
небезопасный: Небезопасный
некоторый: некоторые
нельзя: нельзя
немного: немного
непосредственно: непосредственно
нет: Нет
неустранимый: Неустранимые
низкий: низкого
низкоуровневый: низкоуровневый низкоуровневого
никакой: никаких
нужный: нужно
нулевой: нулевой нулевые
обеспечение: обеспечения обеспечение
область: областью область области
обобщенные: Обобщённые
обработка: Обработка обработки
образец: образцом
общий: Общие общим общее
объединение: объединения
объект: объектов
объектный: объектно
обычный: обычными
один: одна
однопоточный: однопоточного
означать: означает
окружение: окружение
он: его он
она: её
они: Они
оператор: Операторы
операция: операцию
определение: Определение
определить: определить определены
определять: определяет
опровержимость: Опровержимость
оптимизация: оптимизация оптимизации
организация: Организация
ориентировать: ориентированного ориентированных
основа: основе
отсутствие: отсутствия
оценка: оценки
очень: очень
очистка: очистке очистка
ошибка: ошибок ошибки ошибках
пакет: пакетов Пакеты
память: памяти
пара: пары
параллелизм: параллелизм
параллельный: параллельного
перебирать: перебирает
перевод: Переводы
переводить: переводит
передача: передачи
переменный: Переменные переменными переменных переменной переменную
перемножать: перемножаем
пересылка: Пересылка
перечисление: Перечисления
писать: писать
платить: платить
поведение: поведения
повторяться: повторяющийся
подразумевать: подразумеваем
подробнее: Подробнее
подсчет: подсчётом
подчиняться: подчиняется
позволять: позволяют
поискали: поискали
полезный: Полезные
получение: Получение
получить: получить полученный
пользовательский: пользовательских
пользоваться: пользуетесь
помощь: помощью
понимание: Понимание
последовательность: последовательности
потеря: потери
поток: потока поток потоков потоками
потреблять: потребляющих
поэтому: поэтому
превращение: Превращение
предисловие: Предисловие
предоставлять: предоставляет
предсказание: предсказания
представление: представление
представлять: представляют
предыдущий: предыдущих предыдущими
привести: привести приведём
привет: Привет
приводить: приводить
приложение: Приложения приложениях
применить: применить
пример: Пример примера примере примером
примерно: примерно
принцип: принципу
проверить: проверить
проверка: проверок
программа: программы
программирование: программирования Программирование
продвинуть: Продвинутые
проект: проектами Проект проекта проекте
проектирование: проектирования
производительность: производительности производительность производительностью
профиль: профилей
публикация: Публикация публикации
путь: Пути путей
работа: Работа работы
рабочий: Рабочие
разворачивание: Разворачивание
разворачивать: разворачивает
разделять: разделяемого
различный: различные различной
размер: размеров
разместить: разместив
разный: разных разные
разработка: Разработка разработки
разработчик: разработчик
рассмотреть: рассмотрим
расти: растущими
расход: расходов расходы
расширение: Расширение
расширить: Расширенные
расширять: Расширяемый
реализация: Реализация реализации
реальный: реальным
регистр: регистрах
редакция: Редакции
результат: результаты
репозиторий: репозитории
рефакторинг: Рефакторинг
решение: решения
рука: руками
самостоятельно: самостоятельно
самый: самое
свой: своё
связать: связанных связанными
сдвиг: сдвига
сдвигать: сдвигаем
сделать: сделать
сервер: сервера сервер
символ: символы
синтаксис: Синтаксис
слово: слова слово
содержимое: содержимое содержимом содержимого
создавать: создаём
создаваться: создаётся
создание: создание
сообщение: сообщений
соответствовать: соответствовать
соответствующий: соответствующего
сопоставление: сопоставление
состояние: состоянием
сохраняться: сохраняются
список: списков
сравнение: Сравнение
среда: среды
срез: среза срез
срок: сроков
ссылка: Ссылки ссылок ссылками
ссылочные: Ссылочные
стоимость: стоимостью
страуструп: Страуструп
страх: страха
строка: строками строки строку
структура: структур структуры
сумма: суммы
суммировать: суммируем
существовать: существует
таков: таковы
такой: такое таких
текст: текста тексты
теперь: Теперь
тест: тестов тесты тест теста
тестирование: тестирование
тип: Типы Тип типов типа
типаж: типажи
тот: том тот тому то того
точность: точности
требоваться: требуется
трейт: трейта трейтов трейт
трейты: трейты
три: трёх
указание: указания
указатель: указатели указателями указатель
улучшение: улучшения Улучшение
улучшить: улучшили
умный: Умные умными умный
управление: управления Управление
управлять: Управляющие
уровень: уровня
установка: Установка
устранимые: Устранимые
устранять: устраняет
утечка: утечке
файл: файла файлов
финальный: Финальный
функциональность: функциональности
функциональный: Функциональные функциональных
функция: Функции
характеристика: характеристики
хранение: Хранение
целое: целом
цель: целей
цикл: циклы циклов циклом цикла цикл
часто: часто
число: число
чрезвычайно: чрезвычайно
чтение: Чтение
что: чего Что чем
чтобы: Чтобы
шаблон: шаблона Шаблоны шаблон
эквивалентный: эквивалентны
экземпляр: экземпляров
элемент: элемент элементов
это: это этого
этот: эти этот этой
эффективный: эффективным
являться: является
явный: явным
язык: Язык языка языков
ясно: ясно
