автоматический: автоматических
амперсанд: амперсанд
аналогично: аналогично
анонимный: анонимные
аргумент: аргументов аргумента аргумент
безбоязненный: Безбоязненный
библиотека: библиотеки
билд: билдов
бинарный: бинарных
больше: больше
больший: больший
большой: большой
буква: буквы букв
быть: будем будут будет
валидация: Валидация
вариант: вариантом вариант
введение: Введение
ввод: вводом
вводить: вводили
веб: веб
вектор: векторами вектор
вернуть: вернёт
верхний: верхней
весь: Все всех
видеть: видели
видимость: видимости
включить: включить
владение: владения владение
вместо: вместо
внимание: внимание
внутренний: внутренняя
возвращать: возвращает
возможность: возможности возможностей
время: время
всегда: всегда
входной: входных
вы: вы вам
вывод: выводом
выводимые: Выводимые
выделить: выделить
вызвать: вызовем
вызов: Вызов
вызывать: вызывать вызываем
выполнение: выполнением Выполнение выполнения
выполнить: выполнить выполнит
выполнять: выполнять
выполняться: выполняться выполняется
выпуск: выпуска
где: где
давать: Давайте
далее: Далее
данные: Данных данные
два: двумя
действие: действия
делать: делали делать
дерево: дереве
добавить: добавив добавим добавить добавили
добавление: добавления Добавление
добавлять: добавлять добавляем
документация: документацией
должный: должна должен должны
дополнительный: дополнительную
допускать: допускающих допускают
доступный: доступные
другой: другой другого другом других
еще: ещё
жизнь: жизни
заботиться: заботимся
завершение: завершение
загадка: загадки
заглавный: заглавную заглавные
задать: заданными
заимствование: заимствование
закодировать: закодированного
замыкание: замыкания
запись: Запись
запрос: запросу запроса запрос запросом
запустить: запустим запустить
заставить: заставит
затем: Затем
затенить: затенённой
захватывать: захватывают
здесь: здесь
знать: знаете
значение: значений значениями значения значение значении значением
игнорировать: игнорировать
игра: игры
избежать: избежать
изменение: изменение
изменяемость: изменяемость
иметь: имеют имеет иметь
имя: именем имя
инициализировать: инициализируем
инструмент: инструменты
интересовать: интересует
использование: Использование
использовать: использующей использовать используя использует используем используете
использоваться: использоваться
итератор: итераторы итераторов
каждый: каждый каждой
какой: каком
качество: качестве
ключ: ключей
ключевой: ключевого Ключевые
книга: книги
код: кода код
коллекция: коллекции
команда: команд командами команды
командный: командной
комментарий: Комментарии
компилироваться: компилируется
компилятор: компилятора
компиляция: компиляцию
конец: конца
консоль: консоли
конструкция: конструкции Конструкция
конфигурация: конфигурации
конфиденциальность: конфиденциальностью
концепция: концепции
который: которые которую которая который которое
крейт: крейтов крейты крейта
куча: куче
лаконичный: Лаконичный
листинг: листинге Листинг
логический: логическое
любой: любого любое любой
макрос: Макросы
место: места
метод: метода метод
мир: Мир
много: много
многопоточный: многопоточного многопоточный
модуль: модулей модуле модуль модуля
модульность: модульности
можно: можно
мочь: могут может могли можем могла
мы: Мы нам нас
мягкий: Мягкое
найти: найдём
наконец: Наконец
написание: Написание
написать: написать
нарушение: нарушения
настройка: Настройка
находиться: находится находятся
начать: начать
наш: нашего нашим наш нашу Наша
небезопасный: Небезопасный
независимо: независимо
некоторый: Некоторые
немного: немного
необходимый: необходим
неустранимый: Неустранимые
нечувствительный: нечувствительной нечувствительного нечувствительным
нигде: нигде
нижний: нижнем нижний нижнему
новый: новую новый новой нового новые
нужный: нужно нужна
оба: обе
обеспечение: обеспечения
область: областью область области
обобщенные: Обобщённые
обрабатывать: обрабатывать
обработка: Обработка обработки
образец: образцом
обратите: Обратите
общий: Общие общим
объединение: объединения
объект: объектов
объектный: объектно
обычный: обычными
один: один одной одном
однопоточный: однопоточного
ознакомьтесь: ознакомьтесь
означать: означать
окружение: окружение окружения
он: он его
она: её ей она
они: их них
оператор: Операторы
определение: Определение
определить: определили определена
опровержимость: Опровержимость
опция: опцию
организация: Организация
ориентировать: ориентированного ориентированных
основа: основе
оставить: оставим
отключить: отключить
отличный: Отлично
отредактировать: отредактировали
очистка: очистке очистка
ошибка: ошибок ошибки ошибках ошибкам
ошибочный: ошибочного
пакет: пакетов Пакеты
память: памяти
параллелизм: параллелизм
параллельный: параллельного
параметр: параметром параметр параметрами
первый: первых первый
перевод: Переводы
передавать: передаём
передача: передачи
переименуем: переименуем
переключение: переключения
переменный: переменными Переменные переменной переменную переменная переменным переменных
пересылка: Пересылка
перечисление: Перечисления
писать: писать писали
поведение: поведения
подключить: подключить
подробнее: Подробнее
подсчет: подсчётом
позволить: позволит
поиск: поиска поиски поиске поиском поиск
пока: пока
показать: показано показанная
поле: поля поле
полезный: Полезные полезных
получение: Получение
получить: получить получили
пользователь: пользователь пользователи пользователям
пользовательский: пользовательских пользовательский
помогать: помогает
помощь: помощью
понимание: Понимание
попробовать: попробуем
попробуйте: попробуйте
посвятить: посвящён
последовательность: последовательности
посмотреть: посмотрим
поток: потока поток потоков потоками
потому: потому
потребовать: потребовать
похожий: Похоже
почти: почти
поэтому: поэтому
превращение: Превращение
предисловие: Предисловие
преобразование: преобразования
преобразовать: преобразуем преобразовали
преобразовывать: преобразовывать
привести: привести приведёт
привет: Привет
прием: приёмы
приложение: Приложения приложение
применение: применении
пример: Пример примеру
приоритет: приоритет
проверить: проверить
проверка: проверки Проверка
проверять: проверяем
программа: программы программа программу
программирование: программирования Программирование
продвинуть: Продвинутые
проделать: проделать
продолжать: продолжать
продолжить: продолжим
проект: проектами Проект проекта
проектирование: проектирования
производительность: производительности
пройти: пройти прошли
профиль: профилей
проходить: проходящий проходящего проходит
процесс: процессу
прочитать: прочитать
прояснить: прояснить
публикация: Публикация
пустой: пустой
путь: Пути путей
работа: Работа работы
работать: работаем работает
рабочий: Рабочие
раз: раз
раздел: раздел
разделять: разделяемого
различие: различия
разница: Разница
разный: разных разные
разработка: Разработка разработки
расти: растущими
расширение: Расширение
расширить: Расширенные
расширять: Расширяемый
реализация: Реализация
реализовать: реализовали реализовать
реальный: реальное
регистр: регистра регистру регистры регистре регистр
редакция: Редакции
рефакторинг: Рефакторинг
решать: решают
решить: решить Решите
самостоятельный: самостоятельного
сбой: сбой
свой: своё
связать: связанных связанными
сделать: сделать
сеанс: сеансе сеанса
сейчас: сейчас
сервер: сервера сервер
сигнатура: сигнатура
символ: символы символов
синтаксис: Синтаксис
скелет: скелет
следовать: следовать следует
слово: слова слово
случай: случай случаях случае
случайный: случайного
сначала: Сначала
снова: снова
собираться: собираемся
совпадение: совпадения
содержать: содержит содержащей содержащий содержащую содержащие
содержимое: содержимое содержимого
создавать: создаёт создаём
создаваться: создаётся
создание: создание
сообщение: сообщений
соответствовать: соответствовать
сопоставление: сопоставление
состояние: состоянием
сохраниться: сохраниться
сохранять: сохраняем
список: списков
сравнение: Сравнение сравнением
среда: среды
срез: среза срез
срок: сроков
ссылаться: ссылается
ссылка: Ссылки ссылок ссылками
ссылочные: Ссылочные
стандартный: стандартной
старый: старый старого
стесняться: стесняйтесь
строка: строками строки строку строке строка
строчный: строчных
структура: структур структуры структуру
существовать: существующие
так: так
также: также
такой: такое такая таких
текст: текста текстом текст
теперь: теперь
терминальный: терминальном
тест: тестов тесты теста тест тестами
тестирование: тестирование
тип: Типы Тип типов
типаж: типажи
тот: тому том тот тем того то той
точный: точным
трейт: трейта трейтов трейт
трейты: трейты
увидеть: увидеть
уже: уже
узнать: узнать
указание: указания
указатель: указатели указателями указатель
улучшение: улучшения Улучшение
улучшить: улучшим
уменьшение: уменьшением
умный: Умные умными умный
управление: управления Управление
управляемый: управляемая
управлять: Управляющие управлять
упражнение: упражнения
успешно: успешно
успешный: успешным
устанавливать: устанавливать
установить: установлено установить установлена установленной установленным
установка: Установка
устранимые: Устранимые
утечка: утечке
учет: учёта учётом
учитывать: учитывать
файл: файла файлов Файл
финальный: Финальный
функциональность: функциональности
функциональный: Функциональные
функция: Функции функцию Функция функций
характеристика: характеристики
хотеть: хотели хотим
хотя: Хотя
хранение: Хранение
цикл: циклы
часть: части
чтение: Чтение
что: чего Что
чтобы: Чтобы
чувствительность: чувствительностью
чувствительный: чувствительны чувствительного
шаблон: шаблона Шаблоны шаблон
шаг: шаг
экземпляр: экземпляров экземпляру
элемент: элемент элементов
это: этого это
этот: эту этом Этот эта
язык: Язык языка языков
