абстракция: абстракции
базовый: базовый
более: более
браузер: браузере
будущее: будущем
быть: был будем быть будете
веб: веб
возможно: возможно
вручную: вручную
вы: вы
выбирать: выбирать
выводить: выводит
глава: главе глав
готовый: готовых
дойти: дошли
долгий: долгий
другой: других
еще: ещё
закрепить: закрепить
заметить: заметим
запрос: запросов
идея: идеи
идти: идти
изучить: изучить
использование: использованию
использовать: использовать
качество: качестве
книга: книги
количество: количества
корректный: корректный
который: который которые
крейт: крейтов
легкий: лёгкому
лежать: лежащие
метод: метод методы
многопоточный: многопоточного
мочь: можем может могли
мы: мы нам
надпись: надпись
написать: напишем
научить: Научить
научиться: научиться
начало: начале
начать: начнём
наш: нашего Наш наша
небольшой: небольшого
невозможный: невозможно
немного: немного
непрактично: непрактично
несколько: несколько
низкий: низкий
новый: новому
общий: общие
один: один
однако: Однако
опубликовать: опубликовали
основа: основе
ответ: ответ
отдавать: отдавать
парсинга: парсинга
переходить: переходить
подходить: подходит
полный: полные
помощь: помощью
понадобиться: понадобится
поскольку: Поскольку
последний: последних последний
поток: потоков
поэтому: Поэтому
предоставлять: предоставляют
прежде: Прежде
программирование: программирования
проект: проект проекта
пройти: прошли
пропускной: пропускную
прослушивание: прослушивание
протокол: протоколах
пул: пула пул
путь: путь пути
реализация: реализации
резюмировать: резюмировать
рисунок: рисунке Рисунок
сам: самом
сделать: сделаем Сделать
сервер: сервера сервер
системный: системного
совместный: совместный
соединение: соединения
создание: создание создания
создать: Создать создадим
сокет: сокета
сообщество: сообщества
способ: способ
способность: способность
тема: тем
тот: то те тот
уже: уже
узнать: Узнать
улучшить: Улучшить
уровень: уровень
финал: финала
финальный: Финальный финального
функциональность: функциональность
хороший: лучшим
цель: цель
член: Члены
что: чем
это: Это
этот: этой
язык: язык языках
