автоматический: автоматических автоматического
актер: актёра
активный: активны активных
анализ: анализ
анализатор: анализатор
анализировать: анализируя
анонимный: анонимные
аргумент: аргументов аргументами
ассоциированный: ассоциированную
безбоязненный: Безбоязненный
безопасный: безопасным безопасные безопасного
библиотека: библиотеки библиотеку библиотека Библиотеке
билд: билдов
бинарный: бинарных
близко: близко
более: более
больше: больше
большинство: большинстве
бывать: бывают
быть: будет будут быть были есть было будем была будете
важный: важная важной
валидация: Валидация
вариант: Вариант вариантом
ваш: ваш
введение: Введение
ввод: вводом
веб: веб
вектор: векторами вектора вектором вектор векторе
величина: величине
версия: версия
весь: Все весь всех
видеть: видели видим
видимость: видимости
владелец: владельцев
владение: владения владение
владеть: владеть владеют
вместо: вместо
внешне: внешне
внешний: внешнее
внимание: внимание
внутренний: внутренняя внутренней внутреннюю внутренних внутреннего внутреннем внутренний внутренним внутреннее
внутренность: внутренностям
внутри: внутри
возвращать: возвращает возвращаемого
возможно: возможно
возможность: возможности возможностей возможность
воспринимайте: Воспринимайте
вот: Вот
впоследствии: впоследствии
время: время времени
всегда: всегда
вспомнить: вспомним
встроить: встроенных
вы: вам вы вас
выбор: выбором выбора
вывод: выводом
выводимые: Выводимые
выглядеть: выглядит
выдать: выдаст
вызвать: вызовет вызвать вызвал вызовем
вызов: вызовов
вызывать: вызываем вызывать
выполнение: выполнением Выполнение выполнения выполнении
выполнить: выполнены
выполнять: выполняют
выпуск: выпуска
выходить: выходит
гарантировать: гарантировать
гарантия: гарантиям
где: где
гибкость: гибкости
глава: главе Главы
говорить: говорили
гонка: гонок
давать: даёт Давайте дают
данные: Данных данные данными данным
данный: данную данное
два: два двух две
действие: действия действие действий
действительный: действительными
делать: делать
дерево: дереве
деталь: деталь
добавить: добавим добавить
добавление: добавления
доверять: доверять
довольно: довольно
должный: должны должен
допускать: допускающих
допустимый: допустимой
достигать: достигает
доступ: доступ
другой: другого другие других Другой другое другим
дублер: дублёром дублёр дублёры дублёров
единица: единицу
единоличный: единоличное
единственный: единственных
еще: ещё
жизнь: жизни
завершение: завершение
завершить: завершён
завершиться: завершится
зависимость: зависимости
загадка: загадки
заимствование: заимствование заимствования заимствований
заимствовать: заимствовать
заключаться: заключаются заключается
закодировать: закодированного
заменять: заменяет заменяют
заместитель: заместитель
замыкание: замыкания
запись: Запись
запретить: запрещено запрещены
запускать: запускаем
заранее: заранее
затем: затем
захватывать: захватывают
защищать: защищает
здесь: здесь
знать: знать
значение: значений значениями значения значение значению значением значениях
игра: игры
известный: известный
изменение: изменения Изменение изменением
изменить: изменить изменённое
изменяемость: изменяемость изменяемости
изменяемый: изменяемую изменяемые изменяемое изменяемой изменяемых изменяем
изменять: изменять
изучить: изучим
изящный: изящна
иметь: иметь имеет имеют
имитатор: имитатор
имя: именем
инвариант: инварианты
иногда: Иногда
иной: иного
инструмент: инструменты
инсценировочная: Инсценировочные
интересный: интересной
интерфейс: интерфейсом
использование: Использование использования использованием
использовать: использующей использует использовать использующие используем использовали используя
использоваться: использоваться используется
испытывать: испытывать
исследование: исследования
итератор: итераторы итераторов
каждый: Каждый
казаться: казался
какой: каком какие какое
каскадер: каскадёра
катастрофический: катастрофического
качество: качестве
квота: квоты
кинематограф: кинематографе
клонирование: клонирование
ключ: ключей
ключевой: ключевого Ключевые
книга: книги
код: кода код коде
количество: количества количество
коллекция: коллекции
команда: команд
командный: командной
комментарий: Комментарии
компилироваться: компилироваться компилируется
компилятор: компилятору компилятор компиляторе компилятора
компиляция: компиляции
консервативный: консервативен консервативным
конструкция: конструкции Конструкция
контекст: контексте
конфиденциальность: конфиденциальностью
концепция: концепции концепцию
корректный: корректную
который: которые который которых которая которой котором которое
крейт: крейтов крейты крейта
куча: куче
лаконичный: Лаконичный
листинг: Листинг листинге листинга
любой: любой
макрос: Макросы
максимально: максимально
максимальный: максимальному
место: места
метод: метода методов метод методе методы
механизм: механизм механизмом
мир: Мир
много: много
многопоточный: многопоточного многопоточный многопоточном многопоточной
множественный: множественное
модификация: модификация
модуль: модулей
модульность: модульности
можно: можно
мокнуть: мок
момент: момент
мочь: могут может можем можете мог могли
мы: мы нас Нам
мягкий: Мягкое
название: названием
называться: называется
наличие: наличии Наличие
намеренно: намеренно
написание: Написание
написать: написать
напомнить: Напомним
например: Например
нарушение: нарушения
нарушить: нарушите нарушить
насколько: насколько
настройка: Настройка
находить: находить
находиться: находится
начать: начать
наш: нашего Наша нашу наш нашей наши наших
небезопасный: Небезопасный небезопасном
небольшой: небольшие
невозможный: невозможно невозможен
недопустимый: недопустимо
недостаток: недостатки
неизменный: неизменным неизменного неизменных
неизменяемый: неизменяемых неизменяемым неизменяемые неизменяемого неизменяемое неизменяемую неизменяемый
некорректный: некорректную
некоторый: Некоторые некоторый некоторых
немного: немного
необходимый: необходимо
несколько: нескольких несколько
несмотря: несмотря
нет: нет
неудачно: неудачно
неудобство: неудобства
неустранимый: Неустранимые
низкий: ниже
ничто: ничего
новый: новый новые
нужный: нужно нужен
оба: оба обе
обеспечение: обеспечения
область: областью область области
обнаруживаться: обнаруживаться
обнаружить: обнаружить
обобщенные: Обобщённые
обойти: обойти
оборачивать: оборачиваем
оборачиваться: оборачивается
обрабатывать: обрабатывает
обработка: Обработка обработки
образ: образом
образец: образцом
обратите: Обратите
обсудить: обсудим
общий: Общие общим
объединение: объединения
объект: объектов объект объекта объекты
объектный: объектно
обычно: обычно
обычный: обычными обычные Обычный
один: одну одними один Одна одно одной
однако: Однако
одновременно: одновременно
однопоточный: однопоточного однопоточных
ожидать: ожидаемое
ожидаться: Ожидается
означать: означает
окружение: окружение окружении
он: он его ему него
она: она ней
они: они их
оно: оно
оператор: Операторы оператор
определение: Определение определении определению
определенно: определённо
определенный: определённые определённое определённой определённому определённого определённым
определять: определяет определяем
опровержимость: Опровержимость
организация: Организация
ориентировать: ориентированного ориентированных
основание: основания
особый: особый
оставаться: остаётся
остановка: остановки
отклонить: отклонить отклонит
отлавливать: отлавливать
отличие: отличие
отношение: отношению
отправить: отправить отправленные
отправка: отправки
отправлять: отправляет
отслеживание: отслеживания Отслеживание
отслеживать: отслеживает отслеживать
отслеживаться: отслеживаться
очистка: очистке очистка
ошибка: ошибок ошибки ошибках ошибка ошибку ошибке
пакет: пакетов Пакеты
память: памяти
паника: панику
параллелизм: параллелизм
параллельный: параллельного
параметр: параметром параметра параметр
паттерн: паттерн
первый: первый
перевод: Переводы
передавать: передаём передают
передать: передать
передача: передачи
переменный: Переменные переменными переменной переменную
пересылка: Пересылка
перечисление: Перечисления
печатать: печатаем
писать: писать
письмо: письмо письма
поведение: поведения поведение
поговорить: поговорим
подробнее: Подробнее
подсчет: подсчётом
пожертвовать: пожертвовать
позволять: позволяет позволяя
поздний: поздних позже
пока: пока
показать: показана показанная показать показано
показывать: показывает
полагаться: полагаемся
поле: поле
полезный: Полезные полезен полезна полезно
полностью: полностью
получать: получал получаем
получение: Получение получения
получить: получить получите
пользователь: пользователи пользователя
пользовательский: пользовательских
поместить: поместить
помочь: помочь
помощь: помощью помощи
понимание: Понимание
понять: понять
попробовать: попробовать
попытаться: попытаетесь попытаться
попытка: попытка
поручить: поручены
поскольку: Поскольку
последний: Последнее
последовательность: последовательности
посмотреть: посмотрим посмотреть
пострадать: пострадает
потенциально: потенциально
потеря: потери
поток: потока поток потоков потоками
потому: потому
почему: почему
поэтому: поэтому
правило: правилами правила правил правилам
правильно: правильно
практический: практический
превращение: Превращение
превышать: превышающее
предисловие: Предисловие
предложение: предложение
предназначить: предназначен
предоставить: предоставят предоставим
предоставлять: предоставляет предоставлять предоставляют
предупреждение: предупреждения
прежний: прежнему
преимущество: Преимущества Преимущество
приближение: приближения
привести: привести
привет: Привет
приложение: Приложения приложение
применение: Применение
применяться: применяется применяются
пример: Пример
принадлежать: принадлежит
принимать: принимающий принимаем принимает
принять: принял принята принять
причина: причинам причин
проблема: проблема
проверить: проверенные проверить
проверка: проверки проверка проверкой
проверять: проверяем
проверяться: проверяются
программа: программы программа программу программе
программирование: программирования Программирование
программист: программист
продвинуть: Продвинутые
проект: проектами Проект проекта
проектирование: проектирования
производительность: производительности производительность производительностью
произойти: произойдёт
происходить: происходящих происходит
профиль: профилей
процент: процентов
процесс: процессе
прочий: прочего
прямой: прямой
публикация: Публикация
пустой: пустым пустой пустого
путь: Пути путей путём
пытаться: пытаемся
работа: Работа работы
работать: работая работаете работает
рабочий: Рабочие рабочем
равный: равное
раз: раз
развернуть: развернут
раздел: раздел
разделять: разделяемого
разный: разных разные
разобрать: разберём
разработка: Разработка разработки
разрешать: разрешает разрешают
разрешаться: разрешаются
разрешить: разрешено разрешит разрешены
разыменование: разыменования
рамка: рамки
ранний: раньше
рассматривать: рассматривать
рассмотреть: рассмотрим
расти: растущими
расширение: Расширение
расширить: Расширенные
расширять: Расширяемый
реализация: Реализация реализации
реализовать: реализует реализовано реализовать реализуем реализуют
регулировать: регулирующие
редакция: Редакции
рефакторинг: Рефакторинг
решение: Решение
самостоятельно: самостоятельно
самый: самый самым
сведение: сведения
свой: своё своей своих своём
свойство: свойства
связать: связанных связанными
сделать: сделать сделали
себя: себя
сервер: сервера сервер
сигнатура: сигнатуре сигнатура
символ: символы
синтаксис: Синтаксис
ситуация: ситуацию ситуации ситуация
сказать: сказать сказано
сколько: сколько
скомпилировать: скомпилировать
следить: следим
следствие: Следствием
следующий: следующую
слово: слова
сложный: сложной
служить: служить
случай: случае случаев
см: см
смочь: сможет смогут
смысл: смысле
сначала: Сначала
соблюдаться: соблюдаться
соблюдение: соблюдением
совместно: совместно
содержать: содержит содержать
содержимое: содержимое
создавать: создаём создавать создаёт
создаваться: создаётся создаются
создание: создание создании создания
создать: создать создадим создали
сообщение: сообщений сообщения сообщение сообщением
соответственно: соответственно
соответствовать: соответствовать соответствует
соответствующий: соответствующие
сопоставление: сопоставление
составлять: составляет
состояние: состоянием
состоять: состоит
сохранить: сохраним
сохранять: сохраняют сохраняем сохранять
сочетание: сочетании
список: списков список списком списка списке списках
способ: способов способ
способный: способен
сравнение: Сравнение
среда: среды
средство: средство
срез: среза
срок: сроков
ссылаться: ссылаться
ссылка: Ссылки ссылок ссылками ссылку
ссылочные: Ссылочные
стандартный: стандартную
статический: Статический
степень: степени
стесняться: стесняйтесь
стоить: стоит
строка: строками строки
структура: структур структуры структуру структуре
суть: сути
сцена: сцены
сценарий: сценарии сценариях сценарий
считаться: считается
так: так
также: также
такой: такое таким Такой такому
там: там
текст: текста текст
текстовый: текстовое текстового
текущий: текущее
тема: темой
теперь: теперь
тест: тестов тесты теста тесте тестом тест
тестирование: тестирование тестирования
тестировать: тестировать
тестовый: тестовым Тестовые тестовых тестовый
техника: техника
тип: Типы Тип типов типа типу типом
типаж: типажи типаж типажа
тогда: тогда
тот: то том теми того тем той тех
трейт: трейта трейтов трейт
трейты: трейты
убедиться: убедиться
увеличивать: увеличивает
уверенный: уверен
уверить: уверены
увидеть: увидеть увидели
угодно: угодно
удобный: удобно
указание: указания
указатель: указатели указателями указатель указателя указателей
улучшение: улучшения Улучшение
уменьшаться: уменьшается
умный: Умные умными умный умного умных
умолчание: умолчанию
управление: управления Управление
управлять: Управляющие
уровень: уровня
установить: установить
установка: Установка
устранимые: Устранимые
утверждение: утверждения утверждении
утечка: утечке
файл: файла файлов Файл
финальный: Финальный
функциональность: функциональности функциональность
функциональный: Функциональные
функция: Функции функцию
характеристика: характеристики
хороший: лучшим
хотеть: хотим
хранение: Хранение хранения
храниться: хранящееся
цель: целям
цикл: циклы
часть: часть частью
число: числа
чтение: Чтение
что: чего Что чем
шаблон: шаблона Шаблоны шаблон шаблоном
экземпляр: экземпляров экземпляр экземпляра экземпляры экземпляром
электронный: электронное электронного
элемент: элемент элементов
этап: этапе этапах
это: это этого
этот: эти этих этом этот этим этой эту Эта
являться: является являются
язык: Язык языка языков языках
