автоматический: автоматических
анонимный: анонимные
аргумент: аргументов аргумент
атрибут: атрибут атрибута атрибутом атрибутов Атрибуты
безбоязненный: Безбоязненный
библиотека: библиотеки
билд: билдов
бинарный: бинарных
близкий: ближе
более: более
больше: больше
быть: будем будет Было есть быть
важный: важно
валидация: Валидация
вариант: вариантов
ваш: ваш
введение: Введение
ввод: вводом Ввод
веб: веб
вектор: векторами
версия: версия
весь: Все всех всё всей
взаимосвязанный: взаимосвязаны
вид: виду видов
видеть: видите видеть
видимость: видимости
включать: включает
включить: включить
владелец: владельцем
владение: владения владение
вместе: вместе
вместо: вместо
внешний: внешний
внимание: внимание
внутренний: внутренняя
возвращать: возвращает
возможность: возможности возможностей возможность
время: время
встроить: встроенной
вход: вход
вы: вы
вывести: вывести
вывод: выводом вывод вывода выводу выводе
выводимые: Выводимые
выводить: выводимых выводит
выглядеть: выглядеть выглядит
вызвать: вызовет
вызов: вызова Вызов вызове
вызывать: вызывая
выполнение: выполнением Выполнение выполнения
выполнять: выполнять
выполняться: выполняется
выпуск: выпуска
выражение: выражения выражение
высота: высоты высоту высотой высота
вычисление: вычисление
вычислить: вычислить
вычислять: вычисляет вычислять
где: где
глава: главы главе главах
говорить: говорит
гораздо: гораздо
давать: давайте даёт
далекий: дальше
данные: Данных данные данным
данный: данного данный данное
дать: дали
два: два
действие: действия
делать: делает
дерево: дереве
длина: длину
добавим: добавим
добавить: добавить
добавление: добавления Добавление
добавлять: добавляем
довольно: довольно
должный: должна должны
дополнение: дополнение
дополнительный: дополнительной
допускать: допускающих
доступ: доступ
друг: друг другом
другой: другая другой других другим
единица: единиц
единый: единым
еще: ещё
жизнь: жизни
забыть: забыть
завершение: завершение
загадка: загадки
задать: заданного
заимствование: заимствование заимствованием заимствования
заимствовать: заимствовать заимствованного
заключаться: заключается
закодировать: закодированного
замечание: замечание
замыкание: замыкания
запись: Запись
заполнитель: заполнителем
запуск: запуске
запустить: запустим
запятая: запятые
затем: затем
захватывать: захватывают
здесь: Здесь
значение: значений значениями значения значениям значение значением
игра: игры
известный: известное известный
изменение: изменениями
изменяемость: изменяемость
измерение: измерением
изучить: изученные
иметь: имеет имеем иметь имеют
имя: имён именем имя имена
индекс: индексом индекса
индексировать: индексировать
инструмент: инструменты
интересовать: интересует
информация: информации
использование: Использование использования
использовать: использующей используя использовать использующая используем используемый использует использовали
использоваться: использоваться используется
итератор: итераторы итераторов
их: их
каждый: каждым
ключ: ключей
ключевой: ключевого Ключевые
книга: книги
когда: когда
код: кода код кодом
коллекция: коллекции
команда: команд
командный: командной
комментарий: Комментарии
компилятор: компилятор
компиляция: компиляции
конечный: конечным
конкретный: конкретный
консоль: консоль
конструкция: конструкции Конструкция
конфиденциальность: конфиденциальностью
концепция: концепции
короткий: коротких
кортеж: Кортежи кортежей кортежа кортеже кортеж
который: которые которая который которую которое
красивый: красивый красивое
крейт: крейтов крейты крейта
кроме: Кроме
крупный: крупные
кто: кто
куча: куче
лаконичный: Лаконичный
легко: Легко
листинг: Листинг листинге
любой: любой любым
макрос: Макросы макрос макроса макросу
менее: менее
место: места местами месте
метод: метода метод
мир: Мир
много: много
многопоточный: многопоточного многопоточный
множество: множество
модуль: модулей
модульность: модульности
можно: можно
мочь: могут может можем
мы: нам Мы нас
мягкий: Мягкое
надо: надо
название: названиями
назвать: назовём названным
назначение: назначения
называть: называют
найти: найдём
намерение: намерения
написание: Написание
написать: напишем написали написать
нарисовать: нарисовать
настройка: Настройка
находиться: находится
начать: начать начнём
наш: нашего Наша нашей наше наши нашим наш
небезопасный: Небезопасный
неизменяемый: неизменяемым
немного: немного
необходимый: необходимо
неоднозначность: неоднозначности
непосредственный: непосредственного
неустранимый: Неустранимые
нигде: нигде
новый: новый
номер: номер
нужный: нужно
оба: оба
обеспечение: обеспечения
область: областью область области
обобщенные: Обобщённые
обработка: Обработка обработки
образ: образом
образец: образцом
обратить: обратите
обсуждать: обсуждали
общий: Общие общим
объединение: объединения
объект: объектов
объектный: объектно
обычный: обычными
один: один одного одной одним
одиночный: одиночных
однопоточный: однопоточного
означать: означает означают
окружение: окружение
он: его ему он
она: её ей она
они: им
оператор: Операторы
описательный: описательные
определение: Определение определением
определенно: определённо
определенный: определённый
определить: определили определена
опровержимость: Опровержимость
организация: Организация
ориентировать: ориентированного ориентированных
осмысленный: осмысленных
отдельный: отдельными
отладка: отладки отладке
отладочный: отладочной отладочным отладочный
отлаживать: отлаживаем
отличие: отличие
отличный: Отлично
отображаться: отображаться
отображение: отображения
отобразить: отобразить
очевидно: очевидно
очевидный: очевидна очевидным
очень: очень
очистка: очистке очистка
ошибка: ошибок ошибки ошибках ошибку
пакет: пакетов Пакеты
память: памяти
параллелизм: параллелизм
параллельный: параллельного
параметр: параметра параметры параметром
первый: первый
перевод: Переводы
передавать: передаём передаёт передавать
передача: передачи
переделать: переделать
переменный: Переменные переменными переменных
перемещение: перемещению
перепутать: перепутаем перепутать
пересылка: Пересылка
перечисление: Перечисления
перечислить: перечислены
печатать: печатать печатает
печать: печати печать
пиксель: пикселях
писать: писать
площадь: площадь площади
поведение: поведения поведение поведением
поговорить: поговорим
подробнее: Подробнее
подсчет: подсчётом
позволить: позволит
позволять: позволяют позволяет
показать: показано
показывать: показывает
поле: поля полям полей полю Поле
полезный: Полезные полезной полезно полезное полезен полезного
получать: получать получает получаем
получение: Получение получения
получить: получим получит
пользователь: пользователем
пользовательский: пользовательских пользовательским
помимо: помимо
помнить: помнить
помочь: помогут
помощь: помощью помощи
понадобиться: понадобиться
понимание: Понимание
понятный: понятна
понять: понять
попробовать: попробуем
попытка: Попытка
поработать: поработал
порядок: порядок
последовательность: последовательности
поступить: поступил
поток: потока поток потоков потоками
потому: потому
поэтому: поэтому
превращать: превращая
превращение: Превращение
предисловие: Предисловие
предназначить: предназначен
предоставить: предоставил
предыдущий: предыдущих
привести: привести приведёт
привет: Привет
приводить: приводит
привязать: привязать
прийтись: пришлось
приложение: Приложения приложении
пример: Пример примере примера
примечание: Примечание
примитивный: Примитивные примитивный
принимать: принимающего
присваиваться: присваивается
приходиться: приходится
причина: причине
проблема: Проблема
программа: программы программу программа программе
программирование: программирования Программирование
продвинуть: Продвинутые
продолжить: Продолжив
проект: проектами Проект проекта
проектирование: проектирования
производительность: производительности
происходить: происходит
простой: простой
профиль: профилей
прямоугольник: прямоугольника прямоугольник прямоугольников
публикация: Публикация
путь: Пути путей
пытаться: пытается пытаетесь
работа: Работа работы
работать: работает работать
рабочий: Рабочие
равный: равно
раздел: разделе раздел
разделять: разделяемого
разный: разных
разобраться: разобраться
разработка: Разработка разработки
разработчик: разработчиков
ранее: ранее
распечатать: распечатать
рассказать: расскажем
рассмотреть: рассмотрим
рассчитывать: рассчитывать
расти: растущими
расчет: расчёте
расширение: Расширение
расширить: Расширенные
расширять: Расширяемый
реализация: Реализация реализации
реализовать: реализуют реализует реализованное реализовать
редакция: Редакции
результирующий: результирующим результирующее
рефакторинг: Рефакторинг
ряд: ряд
самый: самый
свой: своё свои
связать: связанных связанными связаны
сгруппировать: сгруппировать
сделать: сделать
сервер: сервера сервер
сигнатура: сигнатуры сигнатуре сигнатура
символ: символы
синтаксис: Синтаксис
скобка: скобок скобки
скомпилировать: Скомпилируем
следующий: следующий следующем
слово: слова
случай: случаях
смотреть: смотрите
смысл: смысла смысл
снова: Снова
собственность: собственности
собственный: собственные
создаваться: создаётся
создание: создание
создать: создадим создали создать
сообщение: сообщений сообщением
соответствовать: соответствовать
сопоставление: сопоставление
состояние: состоянием
сохранять: сохраняет
спецификатор: спецификатора
специфичный: специфичной специфичный
список: списков
способ: способов способ способом
справочник: справочника
сравнение: Сравнение
сразу: сразу
среда: среды
срез: среза
срок: сроков
ссылка: Ссылки ссылок ссылками ссылку
ссылочные: Ссылочные
стандартный: стандартный стандартного
становиться: становится становился
стиль: стиля
сторона: стороны
строка: строками строки строке
структура: структуры структур структуру структурой структуре
сущность: сущности
считать: считает
так: так
также: также
такой: такое Таким таких такому
там: там
текст: текста
теперь: Теперь
тест: тестов тесты
тестирование: тестирование
тип: Типы Тип типов типа типам типом
типаж: типажи типажей типаж типажа
торжество: торжество
тот: то Тем того
трейт: трейта трейтов трейт
трейты: трейты
увидеть: увидим увидеть
угадать: угадать
удобный: удобным
уже: уже
указание: указания
указатель: указатели указателями указатель
улучшать: улучшать
улучшение: улучшения Улучшение
улучшить: улучшить
уметь: умеет
умный: Умные умными умный
умолчание: умолчанию
упоминаться: упоминалось
управление: управления Управление
управляемый: управляемым
управлять: Управляющие
упс: Упс
успешно: успешно
установка: Установка
устранимые: Устранимые
утечка: утечке
файл: файла файлов файле Файл
фигурный: фигурных фигурные
финальный: Финальный
формат: формат формате
форматирование: форматирования форматирование форматированием
функциональность: функциональности функциональность
функциональный: Функциональные
функция: Функции функцию Функция
характеристика: характеристики
хороший: лучше
хотеть: хотим хотите
хранение: Хранение
целый: целых
цикл: циклы
частный: частными
часто: часто
часть: части частей
чей: чей
число: число чисел
читабельность: читабельность
читабельный: читабельным
чтение: Чтение чтения
что: чего Что
шаблон: шаблона Шаблоны шаблон
ширина: ширину ширины ширина шириной
экземпляр: экземпляров экземпляр экземпляра
экран: экране
элемент: элемент элементов элементы
это: это этом
этот: Этот эти эта этой этого этими эту
являться: является
явно: явно
язык: Язык языка языков
ясность: ясность ясности
ясный: ясно
