библиотека: библиотек библиотеки
бинарный: бинарному бинарный
более: более
больше: больше
больший: Большая больших большую
большинство: большинство
быстро: быстро
быстрый: быстрее
быть: будете будут будет будем есть
ваш: ваш вашему вашего вашей ваши вашем
ввести: введя
вернуться: вернитесь
версия: версии версий версию
верхний: верхнем верхнего
весь: всего все весь
видеть: видите видели
включение: включение
вместе: вместе
внешний: внешние
внимание: внимание
внутри: внутри
время: время
вручную: вручную
входить: входит
вы: вас вы вами вам
вывод: вывода вывод
выглядеть: выглядеть
выдать: выдала
выполнение: выполнения
выполнить: выполнить
выполнять: выполняет
выполняться: выполняется выполняться
вырастать: вырастают
выяснить: выяснил
где: где
глава: главы главе
гораздо: гораздо
готовый: готовы готов готова
давать: Давайте даёт
данный: данный данном данная данной
два: два
двоичный: двоичный
делать: делали делают
директория: директорию
добавление: добавления
добавлять: добавлять
добавляться: добавляться
документация: документацию документацией
должный: должен должны
дополнительный: Дополнительным дополнительной
доступный: доступные
другой: другим другую другой
еще: ещё
зависеть: зависит
зависимость: зависимостями зависимостей зависимости зависимостях
загляните: загляните
заголовочный: заголовочной
загрузка: загрузка
задавать: задают
задача: задач
заключаться: заключаются
замерять: замеряете
запуск: запуск запуске запуском
запускать: запускать запускают
запустить: запустите запустить запустили запустил
затем: Затем
значительный: значительное
значить: значит
зрение: зрения
игра: игры
изменить: изменить изменили
измениться: изменились
изучение: изучения
изучить: изучили
иметь: имеют
имя: именем имя
инициализировать: инициализировал
инструкция: инструкции инструкций
инструмент: инструмент
инструментарий: инструментария
информация: информации информацию
информирование: информирования
исполняемый: исполняемый исполняемого
использование: использованием Использование использования
использовать: используют использовал используете использовали использованного используя использовать использует
использоваться: использоваться
исходный: исходный исходные исходным
итак: Итак
итог: Итоги
карьера: карьере
каталог: каталог каталоге каталога
ключ: ключе
ключевой: ключевым
книга: книги
код: кода код коду кодом
кодогенерация: кодогенерацию
команда: команда команду командой команды команд
компилировать: компилирует
компилироваться: компилируется
компилятор: компилятор
компиляция: компиляцию компиляции
комплект: комплект
конвенция: Конвенция
конвертировать: конвертировать
контроль: контроля
конфигурационный: конфигурационный
конфигурация: конфигураций конфигурации
концепция: концепции
координировать: координировать
который: которых которые которую которая который
листинг: листинге Листинг
лицензия: лицензии
локально: локально
любой: любую любой любом любых
максимально: максимально
менеджер: менеджер
менять: менять
мера: мере
место: место месте
многие: многие
множество: множество
можно: можно
мочь: можете можем
мы: Мы Нам нас
назвать: назвали
называть: называем называемую
найти: найдена
наконец: наконец
намного: намного
написание: написания
написать: написали написать
напрямую: напрямую
настраивать: настраивают
находиться: находятся находится
начало: началом
начальный: начального
начать: начнёте начали начать
наш: нашего наш нашим
необходимость: необходимость
необходимый: необходимую
несколько: нескольких
нет: нет
никакой: никаких никакие
никогда: никогда
новый: новый нового
номер: номер
нуждаться: нуждаются
нужный: нужны нужен нужно
обновить: обновить
образ: образом
обратите: Обратите
обратитесь: обратитесь
обратно: обратно
общий: общие
один: одну одной один
одинаковый: одинаковы
одновременно: одновременно
ожидать: ожидает
ознакомьтесь: ознакомьтесь
он: он него его
она: она
они: их они
операционный: операционной операционных
оптимизация: оптимизацией Оптимизации
организовывать: организовывать
остаться: оставшаяся
осуществлять: осуществлять
отвечать: отвечает
отдавать: отдавать
отдельно: отдельно
отдельный: отдельный отдельные отдельных
откройте: Откройте
открыть: открыть
отладочный: отладочной
отличаться: отличается
отличие: отличии
отличный: отличное
относить: относящего
официальный: официальные
ошибка: ошибку ошибок
пакет: пакетов пакет пакеты
папка: папку папке папки
параметр: параметры
первый: Первая первом первый
перейти: Перейдите Перейдём
переместите: Переместите
пересобирать: пересобирать
пересобрать: пересобрал
переход: перехода
периодически: периодически
печататься: печатается
писать: пишут писать
по: По
поведение: поведение
повседневно: повседневно
поговорить: поговорим
подкаталог: подкаталог
подобный: подобные подобную
подразумевать: подразумевает
подытожить: подытожим
позволить: позволить
пока: Пока
получение: получения
получить: полученный
пользователь: пользователям
поместить: поместил
помещать: помещает
помнить: помнить
помогать: помогает
помощь: помощью помощи
поскольку: Поскольку
последний: Последняя последнюю последней
последовательность: последовательность
посмотреть: посмотрим
поставка: поставки
постоянно: постоянно
построить: построим
потом: потом
потому: потому
потребоваться: потребуется
почему: Почему
поэтому: поэтому
предназначить: предназначен
предоставлять: предоставляет предоставлять
предпочитать: предпочитаете
предыдущий: предыдущим
преимущество: преимуществом преимуществ
привет: Привет
приводить: приводит
привыкнуть: привыкнуть
пригодиться: пригодится
приложение: Приложении
примечание: Примечание
причина: причине
проверить: проверьте
проверка: проверки
проверять: проверяет проверяете
программа: программы программ программу
программирование: программирования
проект: проектами проект проектов проекта проекте проектом проектах
пропускать: пропускает
простой: простые простых простой
профиль: профиля
процесс: процесс
проще: проще
проявить: проявит
пустой: пустой
путешествие: путешествие
путь: путь
работа: работу работе
работать: работает работать работают
раз: раз
раздел: разделе
различие: различия
разместить: размещёнными
разница: разница
разный: разных
разработка: разработки
разработчик: разработчиков
распространить: распространённая
рассмотреть: рассмотренные
реальный: реального
редактор: редакторе
редакция: редакцию
результат: результаты
релиз: релизу
репозиторий: репозиторий репозитории
решить: решили
сам: сам
самый: Самые
сборка: сборки сборка сборке сборку
свой: свои своём свой свою своё
связать: связанной
сгенерировать: сгенерировал сгенерированы сгенерированное сгенерированным
сделать: сделали
себя: себя
секция: секцией секций секции секция
сеть: сети
система: система системе систему систем
скомпилировать: скомпилировать
следующий: следующее следующие следующей следующую
слово: словом
сложный: сложных сложными
смотреть: смотря
смочь: сможете
собирать: собирать
собрать: соберите собрали собрать
соглашение: соглашения
содержимое: Содержимое содержимым
создавать: создаёт
создание: создание созданию создания
создать: создадим создайте создать
соответствующий: соответствующий
сохранять: сохранять сохраняет
список: списка
способ: способом способа
сравнение: сравнению
сразу: сразу
ссылаться: ссылаются
стабильный: стабильную
стандартный: стандартная
стать: станет стал станут
строка: строка строк строки
существенный: существенной
существовать: существующем
так: так
также: также
такой: таких Таким
текстовый: текстовом
текущий: текущем
теперь: теперь
терминал: терминале
тестируете: тестируете
тип: типа
тоже: тоже
тот: той ту то тем того том
точка: точки
точный: точные
тратить: тратя
три: три
убедиться: убедиться убедитесь
увеличивать: увеличивает
увидеть: Увидим увидеть увидели
угадать: угадай
удобный: удобно
уже: уже
узнать: узнали
указывать: указывает указывающего
управление: управления
управлять: управляет
уровень: уровня
ускорить: ускорит
установить: установили установлен установить установленную
установка: установки Установка установку
файл: файлы файла файл файлом файлов файлу
финальный: финальной
флаг: флаг
формат: формате форматом
хороший: хорошо
хранить: хранит
часто: Часто
часть: часть
число: число
читать: читать
что: что чего чем
этап: этап
это: это
этот: этих Эта этой этот
являться: является
язык: языке
