аргумент: аргумент аргументе аргумента
библиотека: библиотеки
большой: большой
быть: будем будет есть
ваш: вашего
ввести: введите
весь: всего всё
возвращать: возвращает
возможность: возможность
воплощать: воплощает
временной: временную
второй: втором второй
гораздо: гораздо
давать: Давайте
далее: далее
дикинсон: Дикинсон
добавить: добавим добавьте добавили
добавлять: добавляем
другой: Другая
еще: ещё
задача: задач
заключаться: заключается
запустить: запустим
затем: затем
значение: значения
идея: идею
имя: именем
инструкция: инструкцию
использовать: использовать
исправлять: исправлять
качество: качестве
код: код кода
командный: командной
корн: корне
который: которое
листинг: листинге Листинг
любой: любой
малый: меньшие
мера: мере
место: месте места
много: много
мочь: можем могли
мы: нам мы
напечатать: напечатал
начинать: начинать
наш: наша
небольшой: небольшим небольшая
недостаток: недостатков недостатки
несколько: несколько несколькими
новый: новую
нужный: нужен
обрабатывать: обрабатываем
обработка: обработки
образ: образом
обслуживание: обслуживании
объем: объёмом объёмы
один: одну
она: она
открывать: открывает
отличный: Отлично
отрабатывать: отрабатывает
отредактируйте: отредактируйте
ошибка: ошибки
первый: первых первого
печать: печати
повторяться: повторяющимися
подключить: подключить
поисковый: поисковую
пока: Пока
показать: показано
понятнее: понятнее
потому: потому
правило: правило
практика: практикой
представить: представлено
прежде: Прежде
пример: пример
принимать: принимает
проблема: проблема проблемой
проверить: проверить
проверка: проверки
программа: программа программы
проект: проекта
прочитать: прочитал
проще: проще
работать: работать
разработка: разработки
ранний: ранней
реализовать: реализовали
рефакторинг: рефакторинг
рефакторить: рефакторить
решать: решает
рост: роста
сделать: сделаем
слишком: слишком
слово: словами
снова: снова
содержать: содержимого
содержимое: содержимое
создать: Создайте
соответствующий: соответствующую
стадия: стадии
стандартный: стандартной
стихотворение: стихотворение
строка: строки строк строкой
так: так
такой: таким
текст: текста Текст
теперь: Теперь
тестирование: тестирования
тот: том
труднее: труднее
указать: указанного
файл: файла файл файлов
функция: функция
хороший: хорошо хороший Хорошей
часть: часть
чтение: Чтение чтения
что: что
эмили: Эмили
это: этого это
этот: этот эти
являться: являются является
