алан: Алана
архитектура: архитектуру
быть: были Есть
вариант: вариантом
ввести: введены ввёл
возможность: Возможности
глава: главе
год: годах году
друг: друг другу
другой: другим
затем: Затем
идиома: идиомы
использовать: использующим
кея: Кея
компромисс: компромиссы
конкурировать: конкурирующих
концепция: концепция
который: которой которые
много: много
мы: мы
некоторый: некоторым некоторые
нет: нет
обсудить: обсудим
объект: Объекты
объектный: объектно
обычно: обычно
он: он
ооп: ООП
описать: описать
определение: определений
ориентированный: ориентированное ориентированными
ориентировать: ориентированного ориентированным
передавать: передают
повлиять: повлияли
показать: покажем
построение: построения
программа: программ
программирование: программирования программирование
программный: программная
проектирование: проектирования
рассмотреть: рассмотрим
реализовать: реализовать
решение: решением
сильный: сильные
сообщение: сообщения
способ: способ
сторона: стороны
считаться: считаются
термин: термин
тот: то
транслироваться: транслируются
характеристика: характеристики
шаблон: шаблон
это: этого
этот: Эти эту этих этой этим
являться: является
язык: язык языка
