абсолютно: абсолютно
аннотация: аннотаций
аргумент: аргументы аргумент
бинарный: бинарный
блок: блок блоке
более: более
больший: большую
большинство: большинства большинство
буква: буквы
быть: были есть будет будут быть будете
важный: важных важно важное
ввести: введя
вернуть: вернуть
версия: версии
весь: все Весь
взаимозаменяемые: взаимозаменяемые
вид: виду
видеть: видели видеть
видимость: видимости
включать: включали
влиять: влияют
внимание: внимание
возвратить: возвращено
возвращать: возвращают возвращает возвращать возвращаемые возвращаемыми возвращаемое возвращаемый возвращаемым возвращаемого
возвращаться: возвращается
возможно: возможно
вот: Вот
второй: Второй вторых
вход: входа
вы: Вы
вывод: вывод выводе
выглядеть: выглядеть
выдавать: выдавать выдаёт
вызвать: вызвать вызвали
вызов: вызове Вызов вызовов
вызывать: вызывающий вызывает
вызываться: вызывается
выйти: выйти
выполнять: выполняют
выполняться: выполняются
выражаться: выражается
выражение: выражения выражением выражение выражениях
вычислять: вычисляют вычисляющим
вычисляться: вычисляются вычисляется
где: где
главное: главное
давать: давайте
дальнейший: дальнейшего дальнейшем
данный: данном данной данного
два: двумя два
действие: действие
дело: деле
детально: детально
дизайн: дизайне
добавить: добавите
добавлять: добавляем
должный: должны
другой: других другой
единичный: единичным
ее: её
завершать: завершающее завершающих
задать: задан
заканчиваться: заканчивается
заканчивающихся: заканчивающихся
заменить: Замените
заметьте: Заметьте
запуск: Запуск
запустить: запустите запустить
запятая: запятыми запятой
затем: затем
здесь: Здесь
змеиный: змеиный
знать: знает
значение: значения значений значение значениями значением
избежать: избежать
изучать: изучать
изучение: изучения
иметь: имеющие имеете имеет иметь
имя: имён Имя именем
инициализация: инициализации
инструкция: Инструкции инструкций инструкция инструкцию инструкцией
использование: использование
использовать: использует используют использовать использовали используя
исправить: исправить
исходный: исходном
их: их
каждый: каждого
какой: какой какие какое
качество: качестве
ключевой: ключевое ключевого ключевую
когда: когда
код: коде Код кода коду
компилятор: компилятору Компилятор
компиляция: Компиляция
конец: конце конец
конечный: конечного
конкретный: конкретные конкретных
корректный: корректной
который: которая котором которым которую которые который которое которого
круглый: круглых
листинг: Листинге Листинг
любой: любую
макрос: макрос макроса макросов
математический: математическую
место: место местах
можно: можно
момент: момента
мочь: можем могли может можете могут
мы: Мы
набор: набор
название: названием
называть: называем
называться: называются называется
намеренный: намеренное
напечатать: напечатает
написать: напишете
например: например
начинаться: начинается
необходимость: необходимости
необходимый: необходимо
необязательный: необязательно
несколько: нескольких несколько
нет: нет
неявно: неявно
низкий: ниже
ничто: ничего
новый: новые новый
оба: обе
область: области
обратите: Обратите
общение: общении
объявить: объявить
объявление: Объявление объявления
объявлять: объявлять
обычно: обычно
обязанный: обязаны
один: одной один одну одно
одинокий: одинокую
ожидать: ожидает
он: его он
она: ей она
они: они
оператор: оператором
операция: операцию
определение: определения определении определениях Определение определению
определить: определили определена определить определены определён
определять: определяете
основать: основанным
основной: основной
основный: Основное
остальной: остального
отличаться: отличается
ошибка: ошибках ошибку ошибка ошибке ошибки
пара: пары
параметр: Параметры параметров параметр параметра параметрами
первый: Первый первых
передавать: передаваемых передаём
переменный: переменных переменные переменной переменную
печатать: печатает
печататься: печатается
писать: писать
поведение: поведения
повседневный: повседневном
подчеркивание: подчёркивания
позволять: позволяющее позволяет
познакомиться: познакомились
показать: показано
показывать: показывает
полезный: полезные
получить: получить получите получим
поместите: Поместите
помещать: помещает
помните: Помните
помочь: поможет
помощь: помощью
понимать: понимать
попробовать: Попробуем
попробуйте: Попробуйте
пора: пор
порядок: порядке
поскольку: Поскольку
последний: последнее
поставить: поставить
потому: потому
поэтому: поэтому
превратить: превратите превратив
предлагать: предлагает
предоставить: предоставить
представлять: представляют представляет
предыдущий: предыдущий
приводить: приводит
пример: пример примеров примеру
присваивание: присваивание
присвоение: присвоение
присвоить: присвоить присвоенное
проблема: проблему
программа: программ программа программе программу программы
проект: проект проекта
противоречить: противоречит
пытаться: пытается
разделяйте: разделяйте
разделять: разделяет
различие: различие различий различия
ранее: ранее
ранний: раньше
раскрывать: раскрывает
расположить: расположены
распространить: распространены
рассматривать: рассматривали
рассмотреть: рассмотрим
регистр: регистр
результат: результат
результирующий: результирующего
решение: решение
ряд: ряда
сам: самом сам
самый: самых
свой: свои
связать: связать
связываться: связывается
сделать: сделать
себя: собой себе
сей: сих
сигнатура: сигнатуры сигнатурах
символ: символ
синоним: синонимом
скобка: скобок скобки
следовательно: Следовательно
следовать: следует
следом: следом
следующий: следующий следующей следующую
слово: слово слова
случай: случае
сначала: Сначала
содержать: содержащая содержит содержащих содержащий содержащей содержат
создавать: создаёт
создание: Создание
создать: Создадим созданный
сообщать: сообщает
сообщение: сообщение сообщения
составлять: составляют
состоять: состоят
специальный: специальные
стиль: стиль
стрелка: стрелки
строка: Строки строке строка строк
строчные: строчные
так: так
также: также
такой: таких такое такой таким
текст: текст
текущий: текущую
тело: тело Тела
технически: Технически
тип: Тип типов типы типом
тогда: тогда
тот: той том то
точка: точкой точки точек точку
требование: требование
увидеть: увидеть
удалить: удалить
уже: уже
указать: указать указав
указывать: указывают указывать
устранение: устранения
файл: файла файл файле
фигурный: Фигурные фигурных
формат: формата
функция: Функции функций функцией функцию функция
хотеть: хотим
часть: частью часть
человек: люди
число: число
что: чем что
широко: широко
эквивалентный: эквивалентна
это: Это этом
этот: этих этой эту Этот эти эта этого
являться: является являющиеся являются
язык: языке языком языках
