автоматический: автоматических
аннотация: аннотации
анонимный: анонимные
аргумент: аргументов аргументами аргумента аргумент аргументом
безбоязненный: Безбоязненный
безопасность: безопасности
безуспешный: безуспешного
библиотека: библиотеки
билд: билдов
бинарный: бинарных
большой: больше
быть: будут были быть есть было будем будет
важный: важно
валидация: Валидация
введение: Введение
ввод: вводом вводе
веб: веб
вектор: векторами вектор вектору векторе
вернуть: вернуть
вернуться: Вернёмся
версия: версию
весь: Все всего весь вся
вещь: вещей
видеть: видели
видимость: видимости
владение: владения владение
вместо: вместо
внимание: внимание
внутренний: внутренняя
возврат: возврата
возвратить: возвратить
возвращаемое: возвращаемое
возвращать: возвращаемые возвращать возвращает возвращаемого возвращаемый возвращаемым возвращаемыми возвращаем возвращаемую
возможность: возможности возможностей
впоследствии: впоследствии
время: время времени временем временами временах
всегда: всегда
вспомнить: вспомните
вы: вы вас вам
вывод: выводом выводе
выводимые: Выводимые
вызвать: вызвать
вызов: вызова вызов
вызывать: вызывать
выполнение: выполнением Выполнение выполнения
выполните: Выполните
выполнить: выполнит выполнить
выполниться: выполнился
выпуск: выпуска
высокий: высокое
где: где
глава: главе Главы
говорить: говорит говорим
гораздо: гораздо
давать: давайте
далее: Далее
данные: Данных данные
данный: данном данная данный
два: двух
двоичный: двоичного
двойной: двойной
действие: действия
действительный: действительными
делать: делает делали делаем делать
дерево: дереве
дикинсон: Дикинсон
добавить: добавим добавили добавив добавить
добавление: добавления Добавление
добавьте: Добавьте
должный: должна должен должны должно
допускать: допускающих
достаточный: достаточное
другой: Другими Другие
еще: ещё
жизнь: жизни
жить: жить живут
забыть: забудем
завершаться: завершается
завершение: завершение
завершить: завершить
загадка: загадки
заимствование: заимствование
закодировать: закодированного
заметьте: Заметьте
замыкание: замыкания
запись: Запись
запрос: запроса запросу запрос
запуск: запуске
запускаться: запускался
запустить: запустите запустить Запустим
заставить: заставить
затем: Затем
захватывать: захватывают
здорово: Здорово
значение: значений значениями значения значение значением
значить: значит
игра: игры
извлечь: извлекли
изменение: изменения
изменить: изменили
изменяемость: изменяемость
изменяемый: изменяемый
изменять: изменяйте
иметься: имеющуюся
инструкция: инструкции
инструмент: инструменты инструмента
искать: ищет ищем
искомый: искомую
использование: Использование использованием использования
использовать: использующей использовали использует используем
использоваться: использоваться
исправить: исправить
исследовать: исследовать
итератор: итераторы итераторов итератор итераторах итератора итератором
итерация: итерации Итерация
итерироваться: Итерироваться
кавычка: кавычки
каждый: каждой каждый каждого каждую
какой: какого какой
классический: классического
ключ: ключей
ключевой: ключевого Ключевые
книга: книги
код: кода код
коллекция: коллекции
команда: команд
командный: командной
комментарий: Комментарии
компилироваться: компилируется компилировался компилироваться
компилятор: компилятор
консольный: консольных
конструкция: конструкции Конструкция
конфиденциальность: конфиденциальностью
концепция: концепции
косой: косая
который: которые который которую которая которое котором которых
кратко: кратко
крейт: крейтов крейты крейта
куча: куче
лаконичный: Лаконичный
листинг: листинге Листинг
литерал: литерала
логика: логику
макрос: Макросы
место: места
метод: метода метод
минь: мини
мир: Мир
многий: многих
многопоточный: многопоточного многопоточный
модуль: модулей модуль
модульность: модульности
можно: можно
момент: момент
мочь: могут может можем Можете могли
мы: мы нам нами
мягкий: Мягкое
название: названием
назвать: названный
наконец: наконец
напечатать: напечатает
написание: Написание написания написанием написании
написать: Напишите
напомнить: Напомним
например: например
напрямую: напрямую
наращивать: наращиваем
настройка: Настройка
научиться: научились
начало: начало
начать: начать
начинать: начиная
наш: нашего наш наша нашу нашей
небезопасный: Небезопасный
некоторый: некоторый некоторые
немного: немного
необходимость: необходимости
неправильно: неправильно
несколько: нескольким
неудача: неудачей неудачу
неустранимый: Неустранимые
никакой: никаких
ничто: ничего
новый: новый новой
нужный: нужны нужно нужен
оба: обе
обеспечение: обеспечения
обеспечивать: обеспечивающего
область: областью область области
обобщенные: Обобщённые
обработка: Обработка обработки обработку
образец: образцом
обратите: обратите
обратный: обратная
общий: Общие общим
объединение: объединения
объект: объектов
объектный: объектно
обычный: обычными
один: один одна одну
однопоточный: однопоточного
ожидать: ожидаете ожидаемую ожидали
окружение: окружение окружения
он: его он ему
она: она её
они: они их
оператор: Операторы
определение: Определение
определенный: определённой
определять: определяет
опровержимость: Опровержимость
организация: Организация
ориентировать: ориентированного ориентированных
основа: основе
основный: основной
оставить: оставили
открывать: открывающей
отличный: Отлично
отсутствовать: отсутствующее
очистка: очистке очистка
ошибка: ошибок ошибки ошибках ошибкой ошибку
пакет: пакетов Пакеты
память: памяти
пара: пару
параллелизм: параллелизм
параллельный: параллельного
параметр: параметры
перебор: перебора Перебор
перевод: Переводы
передать: переданные передать
передача: передачи
переменный: Переменные переменными переменной
пересылка: Пересылка
перечисление: Перечисления
печатать: печатать
печать: печати
писать: писать Пишите
плохой: плох
поведение: поведения поведение
повторите: Повторите
поговорить: поговорим
поддерживать: поддерживать поддерживая
подробнее: Подробнее
подробно: подробно
подсчет: подсчётом
поиск: поиска поиск поиске
пока: пока
показать: показан показано
покрытие: покрытие
полезный: Полезные полезный полезны
получать: получаем
получение: Получение
получить: получим
пользовательский: пользовательских
помещать: помещать
помогать: помогает
помочь: помочь
помощь: помощью
понимание: Понимание
понимать: понимаем
понять: понять
попробовать: попробуем
пора: пор
поскольку: Поскольку
после: После
последовательность: последовательности
посмотреть: посмотрим
построчный: построчной
потерпеть: потерпеть
поток: потока поток потоков потоками
потом: Потом
потому: потому
поэтому: поэтому
практика: практики
превращение: Превращение
предисловие: Предисловие
предполагать: предполагает
прежний: прежнему
привести: привести
привет: Привет
приложение: Приложения
пример: Пример примеру
принимать: принимать
принцип: принципами
причина: причине
проверить: проверить
проверка: проверки проверку Проверка
проверять: проверяем
программа: программы программу программа программ
программирование: программирования Программирование
программный: программного
продвинуть: Продвинутые
продемонстрировать: продемонстрируем
продолжать: продолжают
проект: проектами Проект проекта
проектирование: проектирования
производительность: производительности
пройти: пройти пройден
проработать: проработаем
протестировать: протестируем протестирована
протяжение: протяжении
профиль: профилей
проходить: проходить проходит
прохождение: прохождение прохождения
процесс: процесса
проще: проще
публикация: Публикация
пустой: пустой
путь: Пути путей
работа: Работа работы
работать: работает работать
рабочий: Рабочие
равный: равен
разбор: разбор разборе
развитие: Развитие
раздел: разделе разделом
разделять: разделяемого
различный: различными
разный: разных
разработка: Разработка разработки разработкой разработке
рассмотреть: рассмотреть
расти: растущими
расширение: Расширение
расширить: Расширенные
расширять: Расширяемый
реализация: Реализация реализацию реализации
реализовать: реализовать
редакция: Редакции
результат: результатов
рефакторинг: Рефакторинг
ровно: ровно
сбой: сбой
свой: своё
связать: связанных связанными связано связан
связывание: связывания
сделать: сделаем
сейчас: Сейчас
сервер: сервера сервер
сигнатура: сигнатуре
символ: символы символ
синтаксис: Синтаксис
сказать: сказать
скомпилировать: скомпилировать
скомпилироваться: скомпилироваться скомпилировался
следовать: следует
следующий: следующую следующие
слово: слова словами словом слово
случай: случае
сначала: сначала
собственный: собственную
совпадать: совпадающие
совпасть: совпали совпавшей совпавшие
содержать: содержат содержит содержащему содержать содержащие
содержаться: содержится
содержимое: содержимом содержимого содержимое
создаваться: создаётся
создание: создание
создать: создать создали
сообщение: сообщений
соответствие: соответствии
соответствовать: соответствовать
соответствующий: соответствующих
сопоставление: сопоставление
состояние: состоянием
состоять: состоит
сохранение: Сохранение сохранения
сохранить: сохранить
сохранять: Сохраняем сохраняя
список: списков списка список
способ: способов способ
срабатывать: срабатывал
сработать: сработал
сравнение: Сравнение
сравнить: сравнить
среда: среды
срез: среза срезы срезов
срок: сроков
ссылаться: ссылаются
ссылающиеся: ссылающиеся
ссылка: Ссылки ссылок ссылками
ссылочные: Ссылочные
стандартный: стандартный
стать: стало станет
стихотворение: стихотворения стихотворении
столько: столько
строка: строками строки строк строку строке строка строкам
строковый: строкового строковые
строчка: строчку
структура: структур структуры
структурировать: структурировать
существовать: существует
счастие: счастью
так: Так
также: также
такой: такое
текст: текста текст
текущий: текущая
тело: тела
теперь: Теперь
тест: тестов тесты тест теста тестами
тестирование: тестирование тестировании
тестовый: тестовой Тестовая
тип: Типы Тип типов
типаж: типажи
тогда: Тогда
тоже: тоже
тот: той те тех тем тому
требовать: требуют
трейт: трейта трейтов трейт
трейты: трейты
три: трёх
убедиться: убедиться убедитесь
увидеть: увидеть
удалить: удалим
удобно: удобно
удостовериться: удостоверимся
узнать: узнали
указание: указания
указатель: указатели указателями указатель
указать: указать указали
указывать: указывают
улучшение: улучшения Улучшение
улучшить: улучшить
умный: Умные умными умный
управление: управления Управление
управлять: Управляющие
успешно: успешно
установка: Установка
устранимые: Устранимые
утечка: утечке
файл: файла файлов Файл
файловый: файловом
финальный: Финальный
функциональность: функциональности функциональность
функциональный: Функциональные
функция: Функции функцию функцией функция
характеристика: характеристики
хотеть: хотим
хранение: Хранение
цикл: циклы цикл циклом цикла
часть: части
черта: черта
читать: читает
чтение: Чтение
что: чего Что
чтобы: Чтобы
шаблон: шаблона Шаблоны шаблон
шаг: шагам шага шаги шаг
экземпляр: экземпляров
элемент: элемент элементов элемента
эмили: Эмили
этап: этапе
это: это
этот: этом этим эту этот этого этому
являться: является
явно: явно
язык: Язык языка языков языки
