автоматически: автоматически
автоматический: автоматических
активный: активных
анонимный: анонимные
аргумент: аргументов
безбоязненный: Безбоязненный
библиотека: библиотеки
билд: билдов
бинарный: бинарных
более: более
больше: больше
больший: большие большая
быть: будет будут быть есть
важный: важные
валидация: Валидация
ваш: вашего ваш ваших
введение: Введение
ввод: вводом
веб: веб
вектор: векторами
версия: версиями версии
весь: Все всех
взглянуть: взглянуть
видимость: видимости
включая: включая
владение: владения владение
вместо: вместо
внести: Внесём
внутренний: внутренняя
возможность: возможности возможностей возможностями
возможный: возможно
воспользоваться: воспользоваться
время: время
вы: вы
выбрать: выбрать
вывод: выводом
выводимые: Выводимые
выполнение: выполнением Выполнение выполнения
выпуск: выпуска выпуску
выпускать: выпускают выпускает
где: где
глава: главе
год: года
давать: даёт
данные: Данных данные
данный: Данное Данная
два: два две
действие: действия
действовать: действуют
дерево: дереве
деталь: деталей
добавление: добавления
добавлять: добавляет
добавляться: добавляются
документация: документацией
должный: должен
допускать: допускающих
доступный: доступны доступна
другой: других
еще: ещё
жизнь: жизни
завершение: завершение
зависимость: зависимостей зависимостью зависимость
загадка: загадки
заимствование: заимствование
закодировать: закодированного
замыкание: замыкания
запись: Запись
захватывать: захватывают
значение: значений значениями значения
игра: игры
идентификатор: идентификаторами
идиом: идиом
изменение: изменения
измениться: изменился
изменяемость: изменяемость
иметь: имеют
инкрементальный: инкрементальные
инструмент: инструменты
инструментарий: инструментарием
использование: Использование использованием
использовать: использующей использовать использует используемой используете использующие
использоваться: использоваться
исходный: исходного
итератор: итераторы итераторов
каждый: Каждые Каждая
какой: какую
ключ: ключей Ключ ключа
ключевой: ключевого Ключевые
книга: книги книга
код: кода код коде
коллекция: коллекции
команда: команд команда команды
командный: командной
комментарий: Комментарии
компилироваться: компилироваться
компилятор: компилятор компилятора компилятором
конструкция: конструкции Конструкция
конфигурационный: конфигурационном
конфиденциальность: конфиденциальностью
конфликтовать: конфликтовать
концепция: концепции
который: которые которая которой
крейт: крейтов крейты крейта
кто: кто
куча: куче
лаконичный: Лаконичный
линковать: линковать
любой: Любой любую
макрос: Макросы
малый: меньшие
мера: мере
место: места
мета: мета
метод: метода
мир: Мир
многопоточный: многопоточного многопоточный
модуль: модулей
модульность: модульности
можно: можно
момент: момент
мочь: могут может
мягкий: Мягкое
надо: надо
назад: назад
накапливаться: накапливаются
написание: Написание написания
написать: написана
настройка: Настройка
начальный: начального
начать: начать
наш: нашего
небезопасный: Небезопасный
небольшой: небольшие
некоторый: некоторые некоторое некоторую некоторых
несовместимый: несовместимые
нет: нет
неустранимый: Неустранимые
новый: новые новую новыми новая новых
нужный: Нужно
обеспечение: обеспечения
область: областью область области
обновить: обновлённой обновить
обновление: обновления
обобщенные: Обобщённые
обработка: Обработка обработки
образ: образом
образец: образцом
обратный: обратной Обратная
общий: Общие общим
объединение: объединения
объединять: объединяет
объект: объектов
объектный: объектно
объясняться: объясняется
обычно: обычно
обычный: обычными
оглянуться: оглянуться
ого: Ого
один: одна
однако: Однако
однопоточный: однопоточного
означать: означают означающий
окружение: окружение
он: его
они: они
оператор: Операторы
определение: Определение
опровержимость: Опровержимость
организация: Организация
ориентировать: ориентированного ориентированных
основный: основном
особенность: особенности
отличный: отличную
отображать: отображает
отсчет: отсчёта
очистка: очистке очистка
ошибка: ошибок ошибки ошибках
пакет: пакетов Пакеты пакетами пакет
память: памяти
параллелизм: параллелизм
параллельный: параллельного
перевод: Переводы
передача: передачи
переключить: переключить
переключиться: переключитесь
переменный: Переменные переменными
пересылка: Пересылка
перечисление: Перечисления
перечисляться: перечисляются
писать: писать
поведение: поведения
поддерживать: поддерживают поддерживаемой
подробнее: Подробнее
подсчет: подсчётом
пока: пока
полезный: Полезные
полный: полной полная
получать: получают получать
получение: Получение получения
пользователь: пользователи пользователей
пользовательский: пользовательских
пользоваться: пользуется пользоваться
помощь: помощью
понимание: Понимание
понятный: понятный
попасть: попали
последний: последних
последовательность: последовательности
поставляться: поставляются
постоянно: постоянно
поток: потока поток потоков потоками
поэтому: Поэтому
превращение: Превращение
предисловие: Предисловие
предшествовать: предшествовала
привести: привести
привет: Привет
приложение: Приложения Приложение
пример: Пример
приносить: приносит
программа: программы
программирование: программирования Программирование
продвинуть: Продвинутые
продолжать: продолжать
проект: проектами Проект проекта
проектирование: проектирования
производительность: производительности
профиль: профилей
процесс: процесса
публикация: Публикация
путь: Пути путей
работа: Работа работы
работать: работает
рабочий: Рабочие
равный: равна
раз: раз
разбор: разбора
разделять: разделяемого
различие: различия
разный: разных разным
разрабатывать: разрабатывает
разработка: Разработка разработки
разработчик: Разработчики
рассказывать: рассказывает
расти: растущими
расширение: Расширение
расширить: Расширенные
расширять: Расширяемый
реакция: реакция
реализация: Реализация
редакция: Редакции редакцию редакция редакций редакциях редакциями
редко: редко
релиз: релизами релизов
рефакторинг: Рефакторинг
свой: своё свой
связать: связанных связанными
сервер: сервера сервер
сигнал: сигналом
сильно: сильно
символ: символы
синтаксис: Синтаксис
ситуация: ситуация
сказать: сказать
скомпилировать: скомпилирован
слово: слова
сложный: сложно
служить: служат
случай: случаях
смочь: сможет
совместимость: совместимости
содержать: содержать
создаваться: создаётся
создание: создание
сообщение: сообщений
соответствовать: соответствовать
сопоставление: сопоставление
состояние: состоянием
список: списков
способ: способ
сравнение: Сравнение
среда: среды
срез: среза
срок: сроков
ссылка: Ссылки ссылок ссылками
ссылочные: Ссылочные
строка: строками строки
структура: структур структуры
такой: такое таким
текст: текста
текущий: текущей
тест: тестов тесты
тестирование: тестирование
тип: Типы Тип типов
типаж: типажи
тот: тех то
точка: точку
трейт: трейта трейтов трейт
трейты: трейты
три: три
увидеть: увидеть
удобный: удобный
указание: указания
указатель: указатели указателями указатель
улучшение: улучшения Улучшение
умный: Умные умными умный
умолчание: умолчанию
управление: управления Управление
управлять: Управляющие
установка: Установка
устранимые: Устранимые
утечка: утечке
файл: файла файлов файл файле
финальный: Финальный
функциональность: функциональности
функциональный: Функциональные
функция: Функции
характеристика: характеристики
хранение: Хранение
целое: целом
цель: целям
цикл: циклы цикл
часто: часто
часть: часть
человек: людей
чтение: Чтение
что: чего Что
шаблон: шаблона Шаблоны шаблон
шестинедельный: шестинедельный шестинедельного
экземпляр: экземпляров
элемент: элемент элементов
этот: эти этой
являться: является
язык: Язык языка языков языках языком
ясность: ясность
