автозаполнение: автозаполнение
автоматически: автоматически
автоматический: автоматическое
анализ: анализа
анализатор: анализатора
более: более
больший: большей
большой: больше
быстрый: быстрый
быть: Будет будут будете
ваш: ваш вашего ваша
ввести: введите
вероятно: Вероятно
весь: все весь всего
взаимодействие: взаимодействия
видеть: видели
включить: включён
возможность: возможности
встроить: встроенные
вы: Вам вы
вызвать: вызовет
вызывать: вызываем
давать: даёт
документация: документацию
должный: должны
домашний: домашнюю
дополнение: Дополнение дополнении
друг: друг другом
запуск: запуска Запуск
запустить: запустив
затем: Затем
идентификатор: идентификатора
изменить: изменён изменил изменить
имя: имя
инструкция: инструкций
инструмент: Инструмент инструмента
интеграция: интеграцию Интеграция
информация: информации
использовать: используемые используют использовать использующего используем
использоваться: использоваться
исправление: исправления Исправление
исправлять: исправлять
какой: какой
клиент: клиенты
код: код кода
коллекция: коллекцией
команда: команда команду
компилятор: компилятора компилятор
конкретный: конкретной
константа: константа константу
корректный: корректной
который: которой которые который
крейт: крейте
линтер: линтер
математический: математическая
многий: Многие
модуль: модуль
мочь: может можем можете могут
мы: мы нас нам
набор: набор
найти: найти
написание: написании
написать: написать
например: Например
начало: начале
наш: наш
нижний: нижнее
никогда: никогда
носить: носит
облегчить: облегчить
одновременно: одновременно
он: его
она: неё
определение: определению
определить: определена
ориентировать: ориентированных
остаться: останется
отформатировать: отформатирует
очевидный: очевидным
ошибка: ошибки ошибку ошибка ошибкам
переменный: переменную переменной Переменная
перемещение: перемещения
переформатировать: переформатирует
переход: переход
пи: Пи
поддержка: поддержку
подключать: подключаемый
подходящий: подходящим
подчеркивание: подчёркивание
получение: получения
получить: получит
помощь: помощью
посетите: Посетите
посмотреть: посмотрим
поэтому: поэтому
появляться: появляется
предлагать: предлагает
предоставлять: предоставляемые
предотвратить: предотвратить
предполагать: предполагает
предположение: предположение
представлять: представляет
предупреждать: предупреждает
предупреждение: предупреждений предупреждения Предупреждение предупреждениям
прежний: прежней
приближенный: приближенная
приводить: приводит
применить: применить
проблема: проблемы
проверка: проверок
программа: программу программе программа
программирование: программирования
проект: проекты проекта
простой: простые
путь: путь
раз: раз
различный: различными
разный: Разные
разработка: разработки
рассказать: расскажем
рассмотреть: рассмотрим рассмотрены
редакция: редакциями Редакции
рекомендовать: рекомендует
свой: свой
себя: собой
семантика: семантика
сервер: сервера
сказать: скажем
скорый: скорее
следующий: следующее следующей следующую Следующий
смотрите: смотрите
снова: снова
совместный: совместные
сообщать: сообщает
сообщество: сообщества сообщество
соответствие: соответствии
спецификация: спецификацией
спор: споры
способ: способом
среда: среде
средство: Средства
стиль: стилем стиль
страница: страницу
также: также
такой: такая такие
текущий: текущем
тело: теле
теперь: теперь
тот: том
точный: точная
увидеть: увидим
уже: уже
улучшить: улучшить
установить: установит установите
установка: установки установку установке
утилит: утилит
файл: Файл
форматирование: форматирование форматирования
форматировать: форматируют
функция: функцию
хотеть: хотите
цикл: цикла
часто: часто
число: число
что: что
это: этом это
этот: этого Эта этот эту
являться: является
язык: языке языков
языковой: языкового
