большинство: большинства Большинство
будущее: будущем
быть: есть будут будете быть
весь: Все
вы: вы вам
выполнение: выполнения
глава: главе
дать: даст
добавить: добавлена
другой: других
задача: задач
зарезервировать: зарезервированных зарезервированы
изучение: изучение
изучить: изучите
иметь: имеют
имя: имён
использование: использования
использовать: использовать
каждый: каждом каждой
качество: качестве
ключевой: Ключевые ключевых
комментарий: комментарии
контекст: контексте
концепция: концепции концепций
который: которая
много: много
мочь: может можете
мы: мы
набор: набор
назначение: назначения
найти: найти
начало: начала
некоторый: Некоторые
нельзя: нельзя
обсудить: обсудим
общий: Общие общего
они: они их них
основа: основе основу
основный: основные
переменный: переменные переменных
помните: Помните
понятие: понятия
поток: поток
почти: почти
правило: правила
представить: представленные
приложение: Приложении
присутствовать: присутствующие присутствовать
программа: программе программах
программирование: программирования
прочный: прочную
работа: работы
работать: работают
различный: различных
разъяснить: разъясним
ранний: ранней
рассматриваться: рассматриваются
свой: своих
сейчас: сейчас
слово: слова слов
специальный: специальные
список: Список
стадия: стадии
тип: типы
тот: то
уникальный: уникальными
управление: управления
фундаментальный: фундаментальные
функциональность: функциональности
функциональный: функционального
функция: функции функций
частность: частности
что: что
этот: этой этих Эти
являться: являются
язык: языке языков языках
