абстракция: абстракции
анализ: анализа анализ
анализировать: анализирует
аналогично: аналогично
аналогичный: аналогичную
анонимный: анонимной
аргумент: аргументов аргументы аргумента аргумент
библиотека: библиотеке библиотеки
библиотечный: библиотечный
бинарный: бинарных бинарной бинарного
блок: блока
более: более
больше: больше
будущий: будущую будущий
быть: будет быть Было будут есть были будем был была
вариант: вариант
ваш: ваша ваше
вверху: вверху
вектор: вектор векторе
вернуть: вернуть вернёт
вероятно: вероятно
вертикальный: вертикальными
весь: всего весь всю всей все вся
взаимодействовать: взаимодействует
взять: взять возьмём
видимость: видимости
владелец: владельцем
владение: владение владения
внесение: внесения
внести: внести внесли
внимание: внимание
вносить: вносить
внутренний: внутреннее
внутри: внутри
возврат: возврата Возврат
возвратить: возвращённый возвращённое возвращённых
возвращать: возвращает возвращаем возвращать возвращали возвращая возвращаемое возвращаемого возвращала
возвращение: Возвращение
возможность: возможность
возможный: возможно
возникать: возникают
возникновение: возникновения
воспользоваться: воспользуемся
вполне: вполне
время: время времени временем
вручную: вручную
всегда: всегда
второй: второй вторых
вы: вы вам
вывести: выведет вывести
вывод: вывода вывод
выглядеть: выглядеть выглядит
выделение: Выделение
выделить: выделена
вызвать: вызовет вызвать
вызов: Вызов вызова вызове
вызывать: вызывает вызывая вызывали вызываем вызывать вызывающего
вызываться: вызывалась вызывается
выйти: вышло выйти
выполнение: выполнения выполнение выполнении
выполнить: выполнено выполнить
выполняться: выполняться
выполняя: Выполняя
выход: выход выхода
выходить: выходим
гарантировать: гарантирует
где: где
глава: Главе
говорить: говорит
группировка: Группировка группировки
давать: Давайте Давай даёт
далее: далее
дальнейший: дальнейшем
данные: данных данными
данный: данный
дать: даст дать
два: две два двух
делать: делает делаем делали
демонстрировать: демонстрирует
детально: детально
диапазон: диапазон
динамический: динамический
длина: длина
длиннее: длиннее
длинный: длинный
добавить: добавить добавили
добавление: Добавление
добавлять: добавляем
должный: должно должны
дополнительный: дополнительный
допустимый: допустимых
доработка: доработка
достаточно: достаточно
достаточный: достаточного
доступ: доступ доступа
друг: друг другом другу
другой: другой другую
дружелюбнее: дружелюбнее
дружественный: дружественное
единичный: единичного
единственный: Единственный
еще: ещё
жизнь: жизни
заботиться: заботимся
завернуть: завернули
завершение: завершения
завершиться: завершится завершилась
задача: задачи задач задачу
заимствование: заимствования
заключаться: заключается
закончить: закончили закончим
заметьте: Заметьте
замечательно: Замечательно
замыкание: замыкания замыкание замыкании
занимать: занимает
заниматься: занимается
запрос: запроса
запуск: запуском запуск
запускать: запускает
запустить: запустите запустить запустим запущен
заранее: заранее
заставить: заставят
затем: затем
здесь: здесь
знать: знает знать знайте
значение: значениями значение значения значений значениям значением
значительный: значительных
идиоматический: идиоматический
идиоматичный: идиоматичным
идти: идёт
избегать: избегать
извлеките: извлеките
извлечение: Извлечение извлечению
извлечь: извлечём извлекли извлечённую
излишний: излишней
изменение: изменения изменение
изменить: изменить изменив изменили изменим
изменять: изменять
изучить: изучите
именовать: именованных именованные
иметь: иметь имеет Имея имеем имеют
иметься: имеющихся
имя: именем имя имена имени
индекс: индексом индексам
индикатор: индикатор
инкрементальный: инкрементальное
инструкция: инструкции
информация: информации информацию
использование: использования использовании Использование
использовать: используем использует использованная использовали использовать используя
использоваться: используются использовались
исправить: исправим
исправление: Исправление исправлением
истинный: истинным
итак: Итак
их: их
каждый: каждая каждой каждому
какой: какой какую какое каких
качество: качестве
клонирование: клонирование
ключевой: Ключевое
когда: когда
код: код кода коде кодом
количество: количество количества количеством
командный: командной
компилироваться: компилироваться
компилятор: компилятор
компромисс: компромисса Компромиссы
конечный: конечных конечным
консолидировать: консолидировать
конструктор: конструктора
конфигурационный: конфигурационных конфигурационного
конфигурация: конфигурации
копировать: копировать
копия: копию копии
корректность: корректность
кортеж: кортеж
который: которые который которую которая котором которой которое
краткий: краткой
краткость: краткости
крейт: крейт крейта
кто: кто
легко: легко
линия: линиями
листинг: Листинг листинге
литерал: литералами
лишний: лишних
логика: логики логику логика логике
любой: любой
макрос: макрос макроса
маленький: мала маленьким маленькой маленький маленькими маленькое
малый: меньшее
менее: менее
меньше: меньше
мера: мере
место: месте место
метод: метод метода методы методом методу
методика: методику
многий: многих многие
много: много
модульность: модульности модульностью
модульный: модульным
можно: можно
момент: момент момента
мочь: может можем могли могут
мы: мы нам нас
название: названия название
названый: назваными
назвать: названную
назначение: назначение назначению
наиболее: наиболее
найти: найден найти
наличие: Наличие
намного: намного
напечатать: напечатаем
написание: написании
написать: написанную написать напишем
напоминать: напоминает
напомнить: Напомним
например: например
напрямую: напрямую
нарушить: нарушили
настоящий: настоящее
настроить: настроить настроены
настройка: Настройка настройкой
находиться: находился
начать: начать
начинать: начинает начиная
наш: нашей нашу наш наших нашего нашем нашим Наша наше
небольшой: небольшими небольшой небольших
независимо: независимо
некоторый: некоторые некоторый
нельзя: нельзя
немедленно: немедленно
немедленный: немедленного
немного: немного
ненулевой: ненулевым
необходимый: необходимые
неоднократно: неоднократно
несколько: нескольких несколько
нести: несёт
нет: нет
неудача: неудачей неудачу
неэффективный: неэффективный неэффективна
никакой: никакой
никогда: никогда
новый: новый новую новой новым
номер: номер
нужный: нужно
нулевой: нулевой
оба: оба обоих
обернуть: обернуть
обертка: обёртки
область: область области
облегчить: облегчит
обнаружение: обнаружении
обновить: обновили обновим обновить
обрабатывать: обрабатывает обрабатывать
обрабатываться: обрабатываются
обработать: обработать обработал
обработка: обработки Обработка обработку обработкой
образ: образом
обратите: Обратите
обратиться: обратимся
обратно: обратно
обстоятельство: обстоятельстве
обсудить: обсудили
обсуждаться: обсуждалось
общий: общей
объект: объект объектов
объявить: объявленную объявлен
обязанность: обязанностей обязанности
ограничить: ограничено
одалживать: одалживать
один: одну одно одном один одного
одинаковый: одинаковы
однако: Однако
ожидать: ожидают
означать: означает
окружать: окружающего
он: его он
она: её она
они: они
оно: оно
оператор: оператора оператор
описать: опишет
описывать: описывает
определение: определение
определенный: определённой
определить: определим определить определён
определять: определяет определяем
оптимизировать: оптимизировать
опустить: опустили
опыт: опыта
организационный: Организационная
оставаться: оставаться остаются остаётся
остальной: остальная остальной остальную
остановить: остановит
остаться: оставшуюся Оставшаяся
ответственность: ответственности ответственность
отвечать: отвечала отвечающую
отдельный: отдельных отдельные
отказ: отказ
относиться: относятся относящийся
отношение: отношения
отображать: отображает
отобразить: отобразит
отражать: отражаем
отразить: отражены
отслеживать: отслеживать
отчасти: отчасти
очень: очень
ошибка: ошибок ошибки ошибке ошибку ошибка ошибкой
память: памяти
паника: панике
паниковать: паникует паниковать
парсер: парсера
первый: первых первом
передавать: передаём передаёт передаваемую
передать: передаст передан
переименование: Переименование
переменный: переменные переменными переменных переменной переменную Переменная
переместить: переместите переместили
перемещение: перемещения перемещению Перемещение
перенесите: Перенесите
перенести: перенесли перенесём
переработать: переработаем
печатать: печатаем
побочный: побочных
поведение: поведение
подготовка: подготовки
поддерживать: поддерживать
поддержка: поддержку
подключение: подключения
подключить: подключить подключили подключены
подобный: подобной
подойти: подойти
подразумевать: подразумевает
подробно: подробно
подходить: подходит
позволить: позволить позволит
позволять: позволяет позволяют
пойти: пойдёт
пока: Пока
показать: показаны показано показанные
показаться: показаться
показывать: показывает
поле: полей полями поля полях
полный: полную
получать: получает получаем
получить: получит получить
поль: полям
польза: пользу
пользователь: пользователю пользователь пользователей пользователям
пользовательский: пользовательские
поместить: поместить поместили поместим
помещать: помещает
помочь: помочь помогло поможет
помощь: помощью
поначалу: поначалу
понижать: понижает
понимать: понимать
понятный: понятным понятно понятное
понять: понять
попробовать: попробуем
попробуйте: Попробуйте
попытаться: попытался
попытка: попытки попыткой
поработать: поработаем
поскольку: Поскольку
постепенный: постепенными
посторонний: постороннюю
потенциальный: потенциальные
потому: потому
потребоваться: потребуется
похожий: похож похоже
почти: почти
поэтому: поэтому
правило: правила
правильно: правильно
правильный: правильной
практичный: практичную
предел: пределы
предназначить: предназначенной
предоставлять: предоставлять
предупреждение: предупреждение
преобразовать: преобразовать
префикс: префикс
приближение: приближение
привести: приведут
приемлемый: приемлемо
признак: признак
принимать: принимает
приобретение: приобретения
присваивания: присваивания
присутствовать: присутствующую
причина: причинам причину
проблема: проблемы проблема проблемой проблеме проблему проблем
проверить: проверить
проверка: проверку проверки
проверять: проверять проверяем проверяемой
проводить: проводим
программа: программы программу программа программе
программирование: программирования
программист: программистов программисты
прогресс: прогресс
продолжить: продолжить
проект: проекта проектов проектах проект
проигнорировать: проигнорировал
производительность: производительности
произойти: произошла
происходить: происходит
простой: простой простым
простота: простоту
протестировать: протестировать
процесс: процесс процесса процессу
прочитать: прочитав
проще: проще
публичный: публичный
путь: путём
пытаться: пытаться
работа: работы работу работа
работать: работает работающую работать
раз: раз
разбор: разбора
развернуть: развернуть развёрнутое
раздел: разделе
разделение: Разделение разделению разделении
разделить: разделить Разделите разделим
разделять: разделяем
различный: различных различные
разница: разницей
разный: разным разных
разработать: разработало
разрешение: разрешения
разумный: разумное
ранее: ранее
распределение: распределения
рассматривать: рассматривали
рассмотреть: рассмотрим
реализовать: реализуем
реализующий: реализующий
результат: результате
рефакторинг: Рефакторинг рефакторинга
решать: решает
решение: решения
решить: решим
рост: роста
руководство: руководства
самый: самый
свой: своей
связать: связанных связана связаны связанную
связывать: связывает
сгруппировать: сгруппировать
сделать: сделать сделает сделаете сделаем сделали сделав
себя: себя
сейчас: Сейчас
сигнал: сигнал
сигнализировать: сигнализирует
сигнатура: Сигнатура сигнатуре сигнатуру
сигнатуры: сигнатуры
синтаксис: синтаксис
синтаксический: синтаксического синтаксический
ситуация: ситуации
скомпилировать: скомпилировать
скомпилироваться: скомпилируется
скорее: Скорее
следовать: следуя
следующий: следующие следующим следующем
слово: слово слова
сложнее: сложнее
сложный: сложной
сломать: сломав
случай: случае случаях
случиться: случилось
смочь: сможем
смысл: смысл смысла
сначала: сначала
снова: снова
собирать: собираем
собственный: собственные
совсем: совсем
соглашение: соглашение
содержать: содержит содержащие содержать содержащей
содержимое: Содержимое
создавать: создаём создавать
создание: Создание
сокращение: сокращение
сообщение: сообщение сообщения сообщением
сообщество: сообщество
соответствие: соответствия
соответствовать: соответствовать
соответствующий: соответствующей Соответствующие
сосредоточить: сосредоточен
состояние: состояния
состоять: состоит
сохранение: сохранение
сохранять: сохраняли
спецификатор: спецификатор
способ: способов способом способ
сработать: сработать
среда: среде
срез: срезы срез
ссылаться: ссылаются
ссылка: ссылки ссылок
стандартный: стандартной
становиться: становится
старый: старым
статический: статической
статус: статус
стоить: стоит
странный: странным
строка: строки строк строку строка строкой
строковый: строковыми
строчка: строчки
структура: структурой структуру структура структуре структуры
существовать: Существует
так: так
также: также
такой: такая такие таким
текст: текст текста
текущий: текущей
тело: теле тело тела
тенденция: тенденция
теперь: теперь
терпеть: терпит
тест: тесты тестов
тестировать: тестировать
техника: техника технику
тип: типа типов тип
типаж: типаж типажи
тот: тем то том того той
точный: Точно
третий: Третья третьих
три: трёх три
труднее: труднее
трудный: трудно
убедиться: убедитесь убедиться
убрать: убрали
увеличиваться: увеличиваться
увидеть: увидеть
удобный: удобным
уже: уже
узнать: узнали
указание: указания
указанный: указанное
указать: указали указать
указывать: указывает указывать
улучшение: улучшения Улучшение
улучшить: улучшенное улучшить
уметь: уметь
управлять: управлять
условие: условии условие
успех: успех успеха
успешный: успешном успешный
уф: Уф
файл: файлы файла файл файле
функциональность: функциональность
функциональный: Функциональные функциональных
функция: функция функции функцию функцией функций
хороший: Лучше лучшей
хорошо: хорошо
хотеть: хотим хотели
цель: цель целью
часто: часто
часть: частей части часть частью
четвертый: четвёртых
четко: чётко
четыре: четыре
чисто: чисто
читать: читает
чтение: чтением Чтение чтения
что: что чем
шаблон: шаблон
шаг: шаги шагами шаг
экземпляр: экземпляр экземпляра экземпляры экземпляром
элемент: элементов
это: Это этом
этот: эта эти этого Этот этому эту этой
эффект: эффектов
эффективность: эффективность
эффективный: эффективные эффективного
являться: являются является
