автоматически: автоматически
автоматический: автоматических
альтернатива: альтернативы
альтернативный: альтернативный
анонимный: анонимные
аргумент: аргументов
базовый: базовыми
безбоязненный: Безбоязненный
безопасность: безопасность
бесконечности: бесконечности
библиотека: библиотеки библиотекой
билд: билдов
бинарный: бинарных
блок: блок Блоки блока блоке
более: более
большинство: большинстве Большинство
бросать: бросает
бывать: бывает
быть: будет быть есть было была будете
важнее: важнее
валидация: Валидация
введение: Введение
ввод: вводом
веб: веб
везде: везде
вектор: векторами
вернуться: вернуться
вероятность: вероятность
вести: ведёт
весь: Все всего весь всех
ветвление: ветвления
ветвь: ветвей Ветви
ветка: ветками ветки
вид: вида
видеть: видим
видимость: видимости
включая: включая
владение: владения владение
вложение: вложений
вложить: вложенными
вместо: вместо
внесение: внесении
внешний: Внешний
внутренний: внутренняя внутреннему Внутренний внутреннего
возвратить: возвращено
возвращать: возвращаемое возвращаемого
возвращение: Возвращение
возможность: возможности возможностей
возможный: возможных возможно
возникнуть: возникнет возникнуть
воспользоваться: воспользовавшись
время: время времени
вручную: вручную
всегда: всегда
вспомнить: Вспомните
встроить: встроенная
второй: вторым
вы: Вы вас
вывод: выводом вывод вывода
выводимые: Выводимые
выводить: выводим
выглядеть: выглядеть выглядит
вызвать: вызвать вызовет
вызывать: вызывает
выиграть: выиграл
выйти: выйти выйдет
выполнение: выполнением Выполнение выполнения выполнении
выполните: выполните
выполнить: выполнить
выполнять: выполнять выполняйте выполняет
выполняться: выполняется выполняться выполняющийся
выпуск: выпуска
выражение: выражения Выражение выражениями выражениях выражении выражений выражением
выход: Выход выхода
выходить: выходим
вычисление: вычисления
вычисляться: вычисляется
вычисляются: вычисляются
гарантия: гарантий
где: где
генерирование: Генерирование
генерировать: генерирует
гипотетический: гипотетических
глава: главы главе глава
го: го
говорить: говорит говорили
готовый: готовы
граница: границах
давать: давал давайте
даже: Даже
далекий: далёкого дальше
данные: Данных данные
данный: данном данной Данный
два: двумя
двенадцать: Двенадцать
двигаться: двигаться
действие: действия действий
действительный: действителен
делать: делает делали делают
делиться: делится
день: дней
дерево: дереве
диапазон: диапазона
добавить: добавить
добавление: добавления
добавлять: добавляем добавляет
догадка: догадки
должный: должно должны должен
допускать: допускающих
достигнуть: достигнет
другой: других другой другого
еще: ещё
желание: желании
жизнь: жизни
забыть: забыть
завершение: завершение завершения
завершить: завершит
зависеть: зависит
зависимость: зависимости
загадка: загадки
загромождение: загромождению
задавать: задаёте
задание: задания
задача: задачи
заимствование: заимствование
заканчивать: заканчивая
закодировать: закодированного
закончиться: закончиться
заметьте: Заметьте
замыкание: замыкания
запись: Запись
запуск: запуска
запускаться: запускался
запустите: Запустите
запустить: запустить Запустим
запятая: запятой
застрять: застряла
затем: затем
захватывать: захватывают
здесь: здесь
знать: знать Зная
значение: значений значениями значения значение значению значением
игра: игры игре игру
извлечь: извлечь
изменение: изменений изменения
изменить: изменить измените
изменяемость: изменяемость
изучение: изучения
иметь: имеет иметь
имя: Имя именем
индекс: индекса
инициализировать: инициализируем
иногда: иногда
инструкция: инструкции Инструкция
инструмент: инструменты
искать: искать
использование: Использование использовании использованием
использовать: использующей использовать используем использовали использованным используемой
использоваться: использоваться используется использовался
истина: истиной
истинно: истинно
истинный: истинного истинным
итератор: итераторы итераторов
итерация: итерации
итог: Итоги
кавычка: кавычки
каждый: каждое каждого каждый каждой
какой: какой какого
каталог: каталоге
качество: качестве
клавиша: клавиш
ключ: ключей
ключевой: ключевого Ключевые ключевое
книга: книги
когда: когда
код: кода код коде
количество: количества количество
коллекция: коллекции
команда: команд
командный: командной
комбинация: комбинацию комбинации
комбинируя: комбинируя
комментарий: Комментарии комментариях
компактность: компактность
компилятор: компилятор
компиляция: компиляции
конвертация: Конвертация
конвертировать: конвертировать
конец: конца
конструкция: конструкции Конструкция конструкциями конструкций конструкцию конструкцией
конфиденциальность: конфиденциальностью
концепция: концепции концепциями
который: которые которым который которое которого которая которую котором
краткий: краткой
крейт: крейтов крейты крейта
куча: куче
лаконичный: Лаконичный
листинг: листинге Листинг Листинга
логический: логического логические логическим
ложный: ложным
любой: любой
макрос: Макросы
массив: массива массиве
медленно: медленно
меньше: меньше
место: места место
метка: Метки метку
метод: метода методом
мир: Мир
многопоточный: многопоточного многопоточный
множество: множества множество
модуль: модулей
модульность: модульности
можно: Можно
момент: момент
мочь: могут может можем можете
мощный: мощная
мы: мы
мягкий: Мягкое
нажать: нажато
название: названием
называть: называют называемая
наиболее: Наиболее
наконец: Наконец
наличие: наличии
напечатать: напечатана напечатанное напечатает
написание: Написание
напоминать: Напоминаем
например: Например
настолько: настолько
настройка: Настройка
находиться: находился
нахождение: нахождения
начало: начало
начать: начать
начинать: начиная
начинаться: начинается начинаться
наш: нашего
небезопасный: Небезопасный
неверный: неверны
недостаточно: недостаточно
некоторый: некоторого некоторый некоторых
нелогический: нелогические
необходимость: необходимости
необходимый: Необходимо
необязательный: необязательно
неоднозначность: неоднозначности
непрерывный: непрерывном
несколько: нескольких несколько несколькими
несовместимый: несовместимые
неудача: неудачей
неустранимый: Неустранимые
ниже: ниже
новый: новый
нужный: нужно
оба: обеих
обеспечение: обеспечения
область: областью область области
обнаружить: обнаружив
обновить: обновить
обобщенные: Обобщённые
обозначать: обозначает
обработка: Обработка обработки
образец: образцом
обратный: обратный обратного
обсуждать: обсуждали обсуждаемыми
общий: Общие общим общем
объединение: объединения
объект: объектов
объектный: объектно
объемный: объёмная
объявлять: объявляем
обычно: обычно
обычный: обычными
один: одного один Одно
одинарный: одинарной
однако: Однако
однопоточный: однопоточного
ожидать: ожидал
ожидаться: ожидалось
окружение: окружение
он: его ему он него
она: её она
они: них их
оператор: Операторы
операция: операции
описать: описана
определение: Определение
определенный: определённое
определяться: определялся
опровержимость: Опровержимость
организация: Организация
ориентировать: ориентированного ориентированных
остальной: остальные остальную
останавливать: останавливая
остановить: остановить
остановиться: остановиться
остановка: остановки
остаться: оставшийся
отличие: отличии
отметить: отметить
отношение: отношении
отслеживать: отслеживать
отсчет: отсчёт отсчёта
очередь: очереди
очистка: очистке очистка
ошибка: ошибок ошибки ошибках ошибка ошибку ошибками
пакет: пакетов Пакеты
память: памяти
паника: панику
параллелизм: параллелизм
параллельный: параллельного
паттерн: паттерн
первый: первый первого
перебор: перебора Перебор
перевод: Переводы
переводчик: переводчика
передать: передать
передача: передачи
перейти: перейдёт перейти
переменный: Переменные переменными переменная переменной переменную переменных
переставать: перестаёт
пересылка: Пересылка
переть: При
переход: перехода
перечисление: Перечисления
песня: песни песне
печатать: печатаем печатает
печататься: печатается
писать: писать
поведение: поведения поведение
повтор: повторами
повторение: Повторение
повторный: Повторное
повысить: повысили
поговорить: поговорим
поддерживать: поддерживают
подробнее: Подробнее
подсчет: подсчётом
подход: подход
позволять: позволяющими позволяет позволяют
пока: пока
показать: показано
полезный: Полезные полезно
получение: Получение получения
получить: получил получим
пользователь: пользователь
пользовательский: пользовательских
поместить: поместите поместить
пометить: помеченному
помещать: помещаем
помнить: помнить
помощь: помощью
понадобиться: понадобиться
понимание: Понимание
понятный: понятна
попробовать: попробуем
попробуйте: Попробуйте
попытка: попытке попыткой
поскольку: Поскольку
последний: последним последнего
последовательность: последовательности последовательность
посмотреть: посмотрите посмотрим
поток: потока поток потоков потоками потоком
потому: потому
потребоваться: потребовались
поэтому: поэтому
появиться: Появится
появляться: появляются
правильный: правильной правильное
правый: правой
практика: практики
превращение: Превращение
предел: пределы
предисловие: Предисловие
предоставить: предоставить
предоставлять: предоставляет предоставляемый
представлять: представляют
прекратить: прекратить прекратит
прерывание: прерывания
привести: привести
привет: Привет
приводить: приводит
привязать: привязана
приказать: приказано
приложение: Приложения
прим: прим
применение: применений
применяться: применяются
пример: Пример примере примера
присваивать: присваивающей
присвоение: присвоения Присвоение
приходиться: приходилось
проблема: проблему
проверить: проверить
проверка: проверка проверки
проверять: проверяет проверяем
проверяться: проверяется
провести: провести
программа: программы программе программа программу
программирование: программирования Программирование
продвинуть: Продвинутые
проект: проектами Проект проекта
проектирование: проектирования
производительность: производительности
производить: производя
произойти: произойдёт
происходить: происходит
пропуск: пропуска
пропустить: пропустит пропустить
противный: противном
профиль: профилей
публикация: Публикация
путь: Пути путей
пытаться: пытаться
пять: пять
работа: Работа работы
рабочий: Рабочие
равный: равен равно равное
равняться: равняется
раз: раз раза
разворот: разворота
раздел: разделе
разделять: разделяемого
разный: разных
разработка: Разработка разработки
распечатайте: Распечатайте
распространить: распространёнными распространённый
расти: растущими
расширение: Расширение
расширить: Расширенные
расширять: Расширяемый
реализация: Реализация
реализовать: реализовать реализована
редакция: Редакции
результат: результат результата результатом результатами результате
рефакторинг: Рефакторинг
рождественский: рождественской
рождество: Рождества
сам: сами самому
свой: своё своего
связать: связанных связанными связанные
сделать: сделать
себя: себе
секретный: секретным
сервер: сервера сервер
сигнал: сигнала
символ: символы Символ
синтаксис: Синтаксис
ситуация: ситуациях
скалярный: скалярных
скобка: скобок
следовать: следует
следующий: следующий следующему следующее следующая следующем следующей следующих
слово: слова слово
случай: случае случаев
смочь: смог сможете
снова: снова
совпадать: совпадают
содержать: содержит
создаваться: создаётся
создание: создание
создать: создайте создадим создать
сообщение: сообщений сообщение
соответствовать: соответствовать
сопоставление: сопоставление
составной: составных
состояние: состоянием состояние
список: списков
способ: способ
справиться: справились
сработать: сработает
сравнение: Сравнение
сразу: Сразу
среда: среды
срез: среза
срок: сроков
ссылка: Ссылки ссылок ссылками
ссылочные: Ссылочные
ставить: ставим
стандартный: стандартной
стоить: стоит
строка: строками строки строка
структура: структур структуры
существовать: существует
счастие: счастью
считать: считать
так: Так
также: также
такой: такое таких такой
текст: текста текст
температура: температур
теперь: теперь
терминал: терминалов терминале
тест: тестов тесты
тестирование: тестирование
тип: Типы Тип типов типа типом типах
типаж: типажи
тот: того то тот
точка: точку
точно: точно
требоваться: требуется
трейт: трейта трейтов трейт
трейты: трейты
три: три
убедиться: убедиться
увидеть: увидеть увидим
угадав: угадав
угадайк: Угадайка
уже: уже
узнать: узнали
указание: указания
указатель: указатели указателями указатель
указать: указать
указывать: указываете указывает
улучшение: улучшения Улучшение
умный: Умные умными умный
управление: управления Управление
управлять: Управляющие управлять
условие: условия условий условие условием
условный: условное условного условными
усложниться: усложнился
успешность: успешности
установка: Установка
устранение: устранения
устранимые: Устранимые
устранить: устранили
устранять: устраняет
утечка: утечке
файл: файла файлов файл
фаренгейт: Фаренгейту
фибоначча: Фибоначчи
фигурный: фигурных
финальный: Финальный
фрагмент: фрагменту
функциональность: функциональности
функциональный: Функциональные
функция: Функции функциях
характеристика: характеристики
хороший: лучше
хранение: Хранение хранения
целочисленный: целочисленного целочисленный целочисленное
цельсий: Цельсию
цепочка: цепочке
цикл: циклы циклов цикла циклами цикле цикл циклом циклу циклах
циклическ: циклически
циклический: циклического
часто: Часто
часть: части часть
четыре: четыре
число: числом число числа чисел
чреватый: чреват
чтение: Чтение
что: чего Что
шаблон: шаблона Шаблоны шаблон
шестой: шестое
эквивалентный: эквивалентно
экземпляр: экземпляров
эксперимент: экспериментов
элемент: элемент элементов элементами элементам элемента
это: это
этот: этот этом этой этого эту эти Эта
являться: являются является
явно: явно
язык: Язык языка языков языках
языковой: языковая
