автоматический: автоматических
аналогичный: аналогичный
анонимный: анонимные
аргумент: аргументов аргумент
асинхронный: асинхронно асинхронных
аспект: аспект
базовый: базовый
безбоязненный: Безбоязненный
бесконечный: бесконечном
библиотека: библиотеки библиотекой
билд: билдов
бинарный: бинарных
более: более
большой: больше
быть: будет есть было будут
валидация: Валидация
вариант: варианта вариант
введение: Введение
ввод: вводом
веб: веб
вектор: векторами
вернуть: вернут
весь: Все всех всё
вид: виду
видимость: видимости
владение: владения владение
владеть: владеет
вместо: вместо
внесите: Внесите
внести: внесённых внести
внимание: внимание
внутренний: внутренняя
возвращать: возвращает
возможно: возможно
возможность: возможности возможностей возможность
воспользоваться: воспользоваться
время: время временем
второй: второй второго
вы: Вы вас вам
вывод: выводом вывод
выводимые: Выводимые
выводить: выводим
выдать: выдать
вызвать: вызвать вызовет
вызов: вызова вызов вызовы
вызывать: вызываем вызывает
выйти: выйдет вышли
выключение: Выключение
выполнение: выполнением Выполнение выполнения выполнению
выполнить: выполнить
выполнять: выполняемые
выполняться: выполняется
выпуск: выпуска
выход: выхода выход
выходить: выходит
где: где
глава: главе
говорить: говорит
говориться: говорилось
гостеприимно: гостеприимно
готовый: готовы
грубый: грубого
давать: Давайте
далее: Далее
данные: Данных данные
данный: данный
два: два две двух двумя
действие: действия действии
делать: делают
демонстрировать: демонстрирует
дерево: дереве
деструктурировать: деструктурировать
добавление: добавления
добавьте: Добавьте
довольно: довольно
дождаться: дождаться
документация: документации
должный: должны должен
допускать: допускающих
другой: Другими другие другой других другим
еще: ещё
ждать: ждал
жизнь: жизни
забирать: забирает
заблокироваться: заблокируется заблокировался
забрать: забрать
завершать: завершал завершают завершает
завершение: завершение завершения завершению
завершить: завершить завершили
завершиться: завершатся завершится завершился
загадка: загадки
задание: задание
задача: задач задачу
заимствование: заимствование
заключаться: заключается
закодировать: закодированного
закрывать: закрывает
закрытие: закрытием
замените: Замените
заменить: заменим
замыкание: замыкания замыканий
запаниковать: запаниковать
запись: Запись
запрос: запросы запроса запросов запрос
запуск: запуска
запускать: запускаемых
запустите: Запустите
запустить: запущена
заставить: заставить
затем: Затем
захватывать: захватывают
захотеть: захотим
знать: знаем
значение: значений значениями значения значение
игра: игры
идея: идей
извлечь: извлечь
изменение: изменения изменений
изменить: изменим изменить
изменяемость: изменяемость
изменяемый: изменяемое
изменять: изменять
иметь: иметь Имейте
инструмент: инструменты
интересный: интересный
использование: Использование использования
использовать: использующей используем использовать использующий
использоваться: использоваться
используйте: Используйте
исправить: исправить
итак: Итак
итератор: итераторы итераторов
итерация: итерацию
итог: Итоги
каждый: каждого каждому Каждый
какой: каких какой
канал: канал канала
клавишный: клавишной
ключ: ключей
ключевой: ключевого Ключевые
книга: книги
когда: когда
код: кода код
коллекция: коллекции
команда: команд
командный: командной
комбинация: комбинацией
комментарий: Комментарии
компилироваться: компилируется
компилятор: компилятор
компиляция: компиляции
конец: конце концу
конкретный: конкретного
конструкция: конструкции Конструкция
конфиденциальность: конфиденциальностью
концепция: концепции
корректно: корректно
корректный: корректного корректное
который: которые которыми который которая
крейт: крейтов крейты крейта крейт
куча: куче
лаконичный: Лаконичный
листинг: Листинг листинге
логика: логике
любой: любыми
макрос: Макросы
максимум: максимум
менее: менее
менять: меняем
место: места месте
метод: метода метод методом методы
мир: Мир
многопоточный: многопоточного многопоточный
модуль: модулей
модульность: модульности
момент: момент
мочь: могут может могли можем мог можете
мы: мы нам нас нами
мягкий: Мягкое
навсегда: навсегда
надежность: надёжность
найдите: найдите
найти: найти
намереваться: намеревались
напечатать: напечатанных
написание: Написание
напоминать: напоминает
напрямую: напрямую
настройка: Настройка
находиться: находятся находится
начать: начать начнём
начинать: начинает
наш: нашего наш наши нашей
небезопасный: Небезопасный
некоторый: некоторые некоторых
немедленно: немедленно
несколько: несколько
неустранимый: Неустранимые
ничто: ничего
но: Но
новость: новость
новый: новые нового новую
номер: номер номером
нужный: нужно
обернуть: обернуть
обеспечение: обеспечения
область: областью область области
обновить: обновить
обобщенные: Обобщённые
обработка: Обработка обработки обработку
обработчик: обработчика
образ: образом
образец: образцом
обратите: Обратите
обратиться: обратимся
обслуживание: обслуживания
общий: Общие общим
объединение: объединения
объединиться: объединиться
объект: объектов
объектный: объектно
объявление: объявление
обычный: обычными
ограничивать: ограничивает
один: один
однопоточный: однопоточного
ожидание: ожидании ожиданием ожидания
ожидать: ожидать
ожидая: ожидая
означать: означает
окончание: окончания
окружение: окружение
он: он его него
они: они них их
оператор: Операторы
опираться: опираться
определение: Определение
определить: определён
опровержимость: Опровержимость
организация: Организация
ориентировать: ориентированного ориентированных
освобождать: освобождаем
освобождение: освобождение
основа: основе
основной: основной
основный: основного
оставлять: оставляя оставляет
остальной: остальные остальных
останавливаться: останавливаются
остановиться: остановились
остановка: остановки
ответ: ответов
отвечать: отвечает
отключать: отключает
отключаться: отключался
отключение: отключении
отличный: Отличная
отправляться: отправляться
очистить: очистил очистив
очистка: очистка очистке
ошибка: ошибок ошибки ошибках Ошибка ошибке ошибку
пакет: пакетов Пакеты
память: памяти
параллелизм: параллелизм
параллельный: параллельного
параметр: параметра
первый: первая первого первых первыми первые
перевод: Переводы
передача: передачи
перейти: перейти
переменный: Переменные переменными
переместить: переместить
перестать: перестать
пересылка: Пересылка
перечисление: Перечисления
печатать: печатает
писать: писать
плохой: плохая
поблагодарить: поблагодарить
поведение: поведения
подключение: подключения
подобный: подобный
подробнее: Подробнее
подсчет: подсчётом
поздравление: поздравления
пока: пока
показать: показана показаны показано
поле: поля
полезный: Полезные
полный: полный
получать: получаем получаемая
получение: Получение получения
получить: получить получили получил
пользовательский: пользовательских
помочь: помочь
помощь: помощью
понимание: Понимание
попытаться: попытаемся попытались
попытка: попытка
порядок: порядок
последовательность: последовательности
постараться: постараются
поток: потока поток потоков потоками потоки потокам потоком
потому: потому
поэтому: поэтому
превращение: Превращение
предисловие: Предисловие
предупреждение: предупреждения предупреждений
прежде: прежде
прекратить: прекратить прекратил
привести: привести
привет: Привет
приводить: приводит
приложение: Приложения
пример: Пример
принимать: принимать принимал
принять: Примите
присоединение: Присоединение
присоединить: присоединить
присоединиться: присоединились
приступить: приступил
причина: Причина
проблема: проблему
проверяя: Проверяя
программа: программы
программирование: программирования Программирование
продвинуть: Продвинутые
продолжить: продолжить
проект: проектами Проект проекта проекты
проектирование: проектирования
производительность: производительности
произойти: произойдёт
происходить: происходит
пройтись: пройдёмся
просить: просит
прослушивание: прослушивание
профиль: профилей
процесс: процесса процессами
публикация: Публикация
публичный: публичные
пул: пула пуле пул пулами
пулом: пулом
путешествие: путешествии
путь: Пути путей
работа: работы Работа работу
работать: работают работать работает
работник: работника работник работники работников
рабочий: Рабочие рабочем рабочих рабочими рабочий
разделять: разделяемого
разный: разных
разработка: Разработка разработки
разработчик: разработчиков
ранее: Ранее
расти: растущими
расширение: Расширение
расширить: Расширенные
расширять: Расширяемый
реализация: Реализация реализации реализацию
реализовать: реализуем реализуемого реализованным реализовать
реализуйте: реализуйте
реальный: реальный
редакция: Редакции
режим: режим
ресурс: ресурсы ресурсов
рефакторинг: Рефакторинг
решить: решить
самый: самым
свой: своё свою свой своей своих свои своём
связать: связанных связанными
сделать: сделали сделайте сделать
себя: себе
сервер: сервера сервер
середина: середине
сигнализация: Сигнализация
символ: символы
синтаксис: Синтаксис
следующий: следующим следующие следующему
слово: слова словами
случай: случаев случае
сначала: Сначала
собственный: собственные
совершенствование: совершенствование
содержать: содержащий
соединение: соединения
создаваться: создаётся
создание: создание создании
сообщение: сообщений сообщение сообщения сообщениям
сообщество: сообщество
сообщить: сообщить
соответствовать: соответствовать
сопоставление: сопоставление
состояние: состоянием состоянии
список: списков
способ: способ
справка: справки
сравнение: Сравнение
сравнить: сравните
среда: среды
срез: среза
срок: сроков
ссылка: Ссылки ссылок ссылками
ссылочные: Ссылочные
столкнуться: столкнуться
строка: строками строки
структура: структур структуры
так: так
также: также
такой: такое таким
текст: текста
текущий: текущей
теперь: теперь
терминал: терминале
тест: тестов тесты
тестирование: тестирование
техника: технику
тип: Типы Тип типов типа
типаж: типажи типаж типажа типаже
тогда: тогда
тот: том тем ту то
трейт: трейта трейтов трейт
трейты: трейты
третий: Третий
три: три
трудность: трудностями
убедиться: убедиться
увидеть: увидеть увидите
удаление: удаления удаление
удалить: удалить удалил
удалять: удалять
удаляться: удаляется
удаться: удался
удовольствие: удовольствием
уже: уже
указание: указания
указатель: указатели указателями указатель
указывать: указывает
улучшение: улучшения Улучшение
умный: Умные умными умный
упоминать: упоминали
управление: управления Управление
управлять: Управляющие
установка: Установка
устойчивый: устойчивую
устранимые: Устранимые
утечка: утечке
файл: файла файлов Файл
финальный: Финальный
функционал: функционала
функциональность: функциональности
функциональный: Функциональные
функция: Функции
характеристика: характеристики
хотеть: хотели хотим хотите
хранение: Хранение
хранить: хранит
цикл: циклы цикле цикл цикла циклов
человек: людям
чтение: Чтение
что: чего Что
шаблон: шаблона Шаблоны шаблон
экземпляр: экземпляров экземпляра
элегантный: элегантный
элемент: элемент элементов элементами
это: этого это этом
этот: этот эту
явно: явно
явный: явного Явное Явный
язык: Язык языка языков языку
