автоматически: автоматически
автоматический: автоматическое Автоматический
аналогичный: аналогичными
аргумент: аргумента аргументы
арсенал: арсенал
ассоциированный: ассоциированными ассоциированную
ассоциировать: Ассоциированные ассоциированы
библиотека: библиотеки
блок: блок блока блоке блоков
более: более
больше: больше
брать: брать берёт брал
будущий: будущих
булевый: булевый
быть: будет был
ваш: вашей ваш ваших
вернуть: вернуть
версия: версии
весь: все
вид: виду
включить: включить
владение: владение
внимание: внимание
внутри: Внутри
возвращать: возвращаемое возвращал возвращающих возвращаемом
возможность: возможность
всегда: всегда
встроить: встроена
второй: второй
входной: входного
вы: вам вы
выбрать: выбрали
вывод: вывод
выглядеть: выглядит выглядеть
вызвать: вызвали вызвать
вызов: вызова вызовы Вызов
вызывать: вызывали вызывающей вызываете
вызываться: вызывается
вызывающий: вызывающего
высота: высота высоту
где: где
геттер: геттерами Геттеры
глава: главе
давать: Давайте
даете: даёте
данные: данные данных
данный: данном
дать: дать
два: два
дважды: дважды
делать: делали делал делают делает
дело: деле
добавить: добавим добавить
добавлять: добавляем добавляет
должный: должен
допустимый: допустимый
доступ: доступ
доступный: доступный
друг: друг другом
другой: другой другие Другими другого
его: его
единственный: единственный
есть: есть
еще: ещё
желаемый: желаемый
заимствование: заимствование заимствованием
заимствовать: заимствует заимствовать
заключаться: заключается
запретить: запретить
запускаться: запускающийся
запустить: запустим
заставлять: заставлять
затем: Затем
здесь: здесь
знать: знает знаем
значение: значение
значительный: значительной
идти: идёт
изменение: изменение
изменить: изменим изменить
изменяемый: изменяемый изменяемое
иметь: иметь имела имеем имеет имеют
имя: имени имя именем имён
инструмент: инструмент
искать: искать
использование: использования использовании Использование использованием
использовать: использовать используем используя использовали
использоваться: используется используются
исходный: исходный
итог: Итоги
каждый: каждого Каждая каждый
какой: какой
качество: качестве
квадратный: квадратного
ключевой: ключевого Ключевые
когда: когда
код: код кода коду
конструктор: конструкторов
контекст: контексте
который: которые которой которого котором который которая которым которое
круглый: круглые
листинг: листинге Листинг листинга
любой: любые любой любых
маленький: меньше
менять: меняем
место: месте местах мест
метод: метода Методы метод методов методом методу методе методами
модуль: модулями модули
мочь: могут можем можете может могли
мы: мы нам нами
название: название
назвать: названный
называть: называемая называют
называться: называются
наличие: Наличие
намного: намного
наоборот: наоборот
написать: написать написанного
например: Например
находиться: находится
наш: нашего
неизменяемый: неизменяемый неизменяемое неизменяемым
некоторый: некоторые
немногий: немногих
необходимость: необходимости
непосредственно: непосредственно
несколько: несколькими несколько нескольких
нет: нет
неявный: неявным
ничто: ничего
но: Но
новый: новый
нужный: нужно нужен
оба: оба
область: области
обобщенный: обобщённые
обозначить: обозначить
образ: образом
обратите: Обратите
обратиться: обратимся
обращаться: обращаясь
обращение: обращение
обсудить: обсудим
общедоступный: общедоступного
объект: объекта объект
объявлять: объявляем
обычно: обычно
обязанный: обязаны
один: один одному одним одну одно
одноименный: одноимённого
ожидать: Ожидаемый
означать: означало
оказаться: оказаться
он: он него
она: она её неё
они: их они им
оно: оно
оператор: оператор оператора
определение: Определение
определенный: определённым определённую
определить: определить определили определим определённые
определяться: определяются
организация: организации
основный: Основная
отличие: отличие
параметр: параметры параметром параметра параметр параметрами параметров
первый: первым первый первого
передавать: передаёт
передать: передали
перемещать: перемещаем
переписать: Переписанный
перечисление: перечисления перечислениям
писать: писать
поведение: поведение
повторять: повторять
поглощать: поглощает
подобный: Подобные подобную
позволять: позволяет позволяют
показать: показано показанную показанному
поле: полей поле поля полю
полезный: полезны полезными
полностью: полностью
получатель: получателя
получить: получим
пользователь: пользователей
поместить: поместили
поместиться: поместиться
помощь: помощью
понимать: понимает
понятнее: понятнее
понятный: понятного понятным
попрактиковаться: попрактикуемся
посмотреть: посмотрев
поступить: поступили
потому: потому
похожий: похожи
поэтому: поэтому
право: право
практика: практике
превращать: превращает
превращение: превращения
предметный: предметной
предоставить: предоставить
предоставлять: предоставляемой
представлять: представляющий
прежний: прежнему
приватность: приватность
приватный: приватным приватного
привязать: привязать
пример: пример
принимать: принимающего принимать
причина: причине причина причин
проверять: проверяет
программа: программу
пространство: пространстве пространств
противный: противном
прочитать: прочитать
псевдоним: псевдонимом псевдонимами
публичность: публичность
публичный: публичным публичного
работа: работы
работать: работает работают
равный: равно
раз: раз
разделять: разделять
различный: различных
размер: размера размеры
разный: разных
разыменование: разыменование
рассматривать: рассматривающей
рассмотреть: рассмотрим
реализация: реализация
реализовать: реализован реализует реализовав
редкий: редким
результат: результат
сам: самом самого
самый: самое
свой: своём свой
свойство: свойства
связать: связано связанную связанных
сделать: сделаем сделать
себя: собой
сигнатура: сигнатуре сигнатуру
сила: силами
синтаксис: Синтаксис синтаксиса
сказать: сказать
скобка: скобок скобки
следовательно: следовательно
следовать: следует
следующий: следующим
слово: слова словами
случай: случае случай
смысл: смысл
снова: снова
собственность: собственности
собственный: собственном собственные
содержать: содержат
создавать: создаём создавать
создание: создание
создать: созданных
сокращать: сокращать
сокращение: сокращением
соответственно: соответственно
соответствовать: соответствовал
сохранить: сохранил
специальный: специальным
способ: способ
способствовать: способствует
ссылка: ссылке ссылки
ставить: ставим
степень: степени
сторона: стороне
структура: структуры структуру структуре структура структур
так: так
также: также
такой: таким такое
тело: теле
теперь: теперь
техника: техника
тип: типом тип типа типе типы
типаж: типажа
тот: то той того тем Тот тому
точка: точку
точно: точно
увидеть: увидим
уже: уже
указатель: указателя указателем
указать: указать указанным указанного
указывать: указывать
упростить: упростит
учитывая: Учитывая
файл: Файл
факт: факт
фигурный: фигурных
фрагмент: фрагменты
функционал: функционал
функциональность: функциональность
функция: функции функций функцию функцией функциях функциями функция
хотеть: хотим хотели хотите
хранить: храните
цель: целей
часто: Часто
часть: часть частям
читать: читает читать
чтение: чтения
что: что
чтобы: Чтобы
ширина: ширина ширину
широкий: шире
эквивалент: эквивалента
эквивалентный: эквивалентен
экземпляр: экземпляр экземпляра экземпляром экземпляре экземпляры экземпляру
эргономичный: эргономичным
это: это этому этом
этот: этот эта эти эту
являться: является являются являющиеся
язык: языки языках язык
