адрес: адрес адресу
амперсанд: амперсанды
аналогичный: аналогичное
более: более
больше: больше
большинство: большинство
большой: большое
бороться: борются
брать: брать
быть: была будет было есть быть
вариант: варианты
вау: Вау
ваш: ваши
ввести: введена
вводиться: вводится
вернуть: вернуть
весь: всего весь все
весьма: весьма
видимость: видимости
висячий: Висячие висячую
владелец: владельцем владельцу
владение: владение владения
владеть: владеет владели
внезапно: внезапно
внимание: внимание внимания
внутри: внутри
возвращать: возвращаемое возвращать
возникать: возникают
время: время времени времена
всегда: всегда
второй: вторых
вы: вы вам вас
вызвать: вызванной
вызов: вызова
вызывать: вызываем вызывают вызывать
выйти: выйдут
выполнение: выполнения
выполнять: выполняемое
выяснять: выяснять
гарантированно: гарантированно
гарантировать: гарантирует
где: где
глава: главе
говорить: говорит
гонка: гонку Гонка гонки гонками
давать: Давайте даёт
данные: данным данные данных
два: две Два
действие: действия
действительный: действительными
деталь: детали
диагностировать: диагностировать
диаграмма: диаграмма
длиться: длиться
добавить: Добавим
должный: должны должно
допускать: допускает
допустимый: допустимое
доступ: доступ доступа
другой: другой других другую другому
его: его
еще: ещё
жизнь: жизни
завершить: завершён
завершиться: завершится
заимствование: заимствование заимствования
заимствованием: заимствованием
заимствовать: заимствованной заимствованное заимствует заимствовать
заканчиваться: заканчиваются
заключаться: заключается
законный: законному
закончить: закончите
запись: записи
заранее: заранее
затем: Затем
здесь: Здесь
значение: значение значений значения
изменение: изменение
изменить: изменить изменит
измениться: изменится
изменяемые: Изменяемые
изменяемый: изменяемую изменяемая изменяемое изменяемой изменяемых
изменять: изменять
изображать: изображает
иметь: имеющую имеют
индикация: индикации
иногда: иногда
использование: использованием использования использование
использовать: использовать используем использует используют использовано
использоваться: использоваться используется использовались
исправить: исправить
исчезнуть: исчезли исчезнет
каждый: каждом
какой: какой какие
касаться: касающиеся
качество: качестве
ключ: ключ
когда: когда
код: кодом код кода
количество: количество
комбинирование: комбинирования
комментарий: комментарии
компилировать: компилировать
компилироваться: компилироваться
компилятор: компилятор
компиляция: компиляции
конец: концом
контролируемый: контролируемым
концепция: концепцию
кортеж: кортежа
который: которому которая которое которые которой который которую
кто: кто кем кому
легко: легко
листинг: листинге листинга Листинг
любой: любого любой любое
менять: меняем
место: места
механизм: механизм механизмы
минимум: Минимум
множественный: множественные
модификация: модификации
момент: момент
мочь: можем могли можете может могут мог
мы: мы нам нас
называть: называем
например: Например
настройка: настроек
находиться: находится
начинаться: начинается
наш: нашего
небольшой: небольших
недействительный: недействителен недействительную недействительными
недопустимый: недопустимую
неизменяемый: неизменяемы неизменяемых неизменяемая неизменяемой неизменяемые
некоторый: некоторое некоторые некоторой
неопределенный: неопределённое
непосредственно: непосредственно
несколько: нескольких несколько
несмотря: Несмотря
нехорошо: нехорошо
никогда: никогда
никто: никто
ничто: ничего
новый: новые новой
нужный: нужно
оба: обе
обеспечить: обеспечит
область: Область области
обновлять: обновляем
образ: образом
обратить: обратите
обращать: обращаете
обсудить: обсудим обсудили
объект: объект
объявление: объявлении
объяснять: объясняющие
ограничение: ограничение ограничения
один: одно одного один одни одна
однако: Однако
одновременно: одновременно
одновременный: одновременное
ожидать: ожидают ожидали
означать: означает
оказаться: оказались
он: ним им него
она: она её неё
они: они ими их них
оно: оно
оператор: оператора
описание: Описание
определение: определении
определенный: определённого
определить: определить
освободить: освобождена освобождено
освобождение: освобождения
особенность: особенности
ответственность: ответственность
отказываться: отказываясь
отличие: отличие
относиться: относится
отследить: отследить
отсутствовать: Отсутствуют
очень: очень
ошибка: ошибка ошибкой ошибки ошибке ошибку
ошибочно: ошибочно
память: памяти память
параметр: параметра параметров
первый: первых Первое
передавать: передаём
передать: передан
перекрываться: перекрываются
переменный: переменной переменные
переместить: перемещена перемещено
переставать: перестаёт
перестать: перестанет
поведение: поведение
повлиять: повлиять
повторить: повторим
подробно: подробно
подробный: подробнее
позаимствовать: позаимствовать позаимствовано
позволить: позволить позволит
позволять: позволяют позволяет позволяющей
пока: пока
показывать: показывает
получить: получить
пользователь: Пользователи
помощь: помощью
понять: понять
попробовать: Попробуйте попробуем
попытаться: попытаться попытались
попытка: попытка
пора: пор
последний: последнего последнее последний
потенциальный: потенциальную
потому: потому
похожий: похожа
почему: почему
поэтому: поэтому
появление: появление
правило: правило Правила
право: право
предоставить: предоставить
предотвратить: предотвратить
предотвращать: предотвращает
предотвращающее: предотвращающее
представлять: представляют
прежде: прежде
преимущество: Преимущество
приводить: приводит
прийтись: придётся
применять: применяет
примечание: Примечание
принадлежать: принадлежат
принимать: принимая
принять: принять
проблема: Проблема проблему проблемой проблем
продолжаться: продолжается
произойти: произойдёт
происходить: происходит
проследовать: проследовать
противоположность: противоположностью
процесс: процесс
путь: путём
пытаться: пытается пытаетесь
работа: работы
работать: работает
раз: раза раз
разочарование: разочарование
разрешить: разрешено разрешены разрешён
разыменование: разыменование разыменования
рассмотреть: рассмотрим рассмотрели
реальный: реальной
решение: Решением
рисунок: Рисунок
сделать: сделать
себя: себя собой себе
сигнатура: Сигнатура сигнатуру
синхронизация: синхронизации
сказать: сказать
скобка: скобки
следующий: следующие следующей
сложный: сложно
смысл: смысле
сначала: Сначала
содержать: содержать
создавать: создаём
создаваться: создаётся
создание: создания созданием
создать: создать
сообщение: сообщение
состояние: состояние
сохранение: сохранении
спойлер: Спойлер
сработать: сработает
срез: срезы
срок: срока
ссылаться: ссылаться ссылается
ссылка: Ссылки ссылку Ссылка ссылкой ссылок ссылками
стать: станут
существование: существования
сценарий: сценария
так: так
также: также
такой: такая такую такими
течение: течение
тип: типа тип
тогда: Тогда
тот: том того то тех те тому
точка: точке
точно: точно
три: три
увидеть: увидим увидеть
удалить: удалено
удаляться: удаляется
указатель: указатель указателя указателей указателями
указывать: указывает указывающей указывающую указывать
умолчание: умолчанию
участок: участок
файл: Файл
фактический: фактических
фигурный: фигурные
функция: функции функцию
храниться: хранящимся
часть: части
человек: человек
читать: читает
чтение: чтение
что: что чем
этап: этапе
это: этого это
этот: этому эти этой эту этот Эта
являться: является
язык: языков языках языка
