автоматический: автоматических
адрес: адресом адрес адреса
анализатор: анализатор
анализировать: анализируя
аналогичный: Аналогично
анонимный: анонимные
аргумент: аргументов
ассоциированный: ассоциированную
безбоязненный: Безбоязненный
безопасность: безопасности
библиотека: библиотеки библиотеку библиотека библиотеке
билд: билдов
бинарный: бинарных
более: более
больше: больше
будущее: будущем
буква: буквы
быть: было будет будете есть были быть была
важный: важно
валидация: Валидация валидации
вариант: вариант варианта
ваш: вашу вашей вашему ваш ваших ваша
введение: Введение
ввести: введённое ввести
ввод: вводом
вводить: вводит
веб: веб
везде: везде
вектор: векторами
вернуть: вернуть
весь: Все весь всего всех
вид: виду
видимость: видимости
владение: владения владение
вместо: вместо
внешний: внешний
внутренний: внутренняя
возврат: возврат
возвращать: возвращаете возвращаемого возвращает возвращающий возвращаем
возвращение: возвращение возвращения
возможность: возможности возможностей возможность
возможный: возможен
восстановить: восстановить
восстановиться: восстановиться
восстановление: восстановления восстановление
вполне: вполне
вредный: вредным
время: время времени
вручную: вручную
всегда: всегда
вспомнить: Вспомним
входной: входные
вы: вы вас вам
выбор: выбором
вывод: выводом
выводимые: Выводимые
вызвать: вызовет
вызов: вызов вызове
вызывать: вызывать вызывающего вызываете вызывает вызывающие вызываем
вызываться: вызывается
вызывающий: вызывающему Вызывающий
выполнение: выполнением Выполнение выполнения
выполнить: выполнить
выполнять: выполняет
выпуск: выпуска
выражение: Выражение выражения
гарантировать: гарантирует гарантируя
гарантироваться: гарантируется
гарантия: гарантия
где: где
глава: Глава главы Главе
готовый: готовы
граница: границ
давать: Давайте
данные: Данных данные данными
данный: данной данную
дать: дать
действие: действия
действительный: действительным действительный
делать: делает делать
делегировать: делегируете
дело: деле
дерево: дереве
дефект: дефект
диапазон: диапазона диапазоне
добавить: добавить
добавление: добавления
добиться: добиться
догадка: догадкам
доказать: доказать
документация: документации
должный: должен должны должна
дополнительный: дополнительные
допускать: допускающих
допустимость: допустимость
допустимый: допустимо допустимой
допущение: допущение
достигнуть: достигли
доступ: доступ
другой: другой другая другого другое других
его: его
еще: ещё
желательно: Желательно
жестко: жёстко
жизнь: жизни
завершение: завершение
завершиться: завершиться
зависимость: зависимости
загадать: загаданным
загадка: загадки
задать: заданного
задокументировать: задокументировать
заимствование: заимствование
заимствовать: заимствует
заканчиваться: заканчиваться
закодировать: закодированного закодированную закодированной закодирован закодировать
замыкание: замыкания
запись: Запись
запрограммировать: запрограммированной
запрос: запрос запросов
заставлять: заставляет
затем: затем
захватывать: захватывают
здесь: здесь
знак: знака
знать: зная
значение: значений значениями значения значение значениях значением значению
игра: игры игру
идеальный: идеальное
идея: идею
известный: известной
извлекатель: извлекатель
извлечь: извлечь
изменить: изменить
изменяемость: изменяемость
иллюстрировать: иллюстрирующий
иметь: имеет иметь имеем имеют
иметься: имеется
имя: имени именем
инвариант: инвариант
иногда: иногда
инструмент: инструменты
информация: информации информацию
использование: Использование использованием использования
использовать: использующей используете использующего использовать использующий использует
использоваться: использоваться используется
исправимый: исправимую
исправить: исправить
источник: источника
итак: Итак
итератор: итераторы итераторов
итерация: итерацию
итог: Итоги
их: их
каждый: каждом каждой
какой: какая какого
качество: качестве
ключ: ключей
ключевой: ключевого Ключевые
книга: книги
когда: когда
код: кода код коду коде
кодирование: Кодирование
коллекция: коллекции
команда: команд
командный: командной
комментарий: Комментарии
компилироваться: компилироваться
компилятор: компилятор компилятора компилятором
конкретный: конкретной
консоль: консоль
конструкция: конструкции Конструкция
контекст: контексте
контракт: контракт контракты контракта
конфиденциальность: конфиденциальностью
концепция: концепции концепцию
корректный: корректное
который: которые который которая которых которым которое которую которой которому котором которого
крейт: крейтов крейты крейта
кто: кто
куча: куче
лаконичный: Лаконичный
лежать: лежит
листинг: Листинг
лицо: лицом
логика: логика логику логикой
логически: логически
любой: любой любая
макрос: Макросы Макрос
мало: мало
маркер: маркеры
массив: массива
менее: менее
менять: меняет
место: места
метод: метода методы метод
мир: Мир
мнение: мнению
много: много
многопоточный: многопоточного многопоточный
многословный: многословным
множество: множества множество
модуль: модулей модуля
модульность: модульности
можно: Можно
момент: момента
мочь: могут может можете мог можем могла
мы: мы нас нам нами
мягкий: Мягкое
надежный: надёжной надёжным надёжного
название: названием
называть: называют
наличие: наличие наличия
написание: Написание написанию
написать: написавшего
например: Например
напрямую: напрямую
нарушать: нарушает
нарушение: нарушении нарушение
нарушить: нарушены
настройка: Настройка
находиться: находится
нахождение: нахождение
начать: начать
наш: нашего наш наши наше
небезопасный: Небезопасный небезопасным
неверный: неверными
невозможный: невозможна невозможно
недопустимый: недопустимые недопустимое недопустимых недопустимы
недостаточно: недостаточно
независимо: независимо
неизбежный: неизбежных
неисправимый: неисправимую
некорректный: некорректном некорректное некорректными
некоторый: некоторыми некоторую некоторое
нельзя: нельзя
необратимый: необратима
необходимость: необходимости
необходимый: необходимо необходимым
неожиданный: неожиданное
неподконтрольный: неподконтрольный
неправильно: неправильно
неправильный: неправильном
несколько: несколько
нет: Нет
неудача: неудачи неудачей неудачу
неустранимый: Неустранимые
никогда: никогда
ничто: ничего
но: Но
новый: новый
нужный: нужно
оба: оба
обеспечение: обеспечения
обеспечить: обеспечил
область: областью область области
обобщенные: Обобщённые
обобщенный: обобщённых
обозначение: обозначением
обрабатывать: обрабатывать обрабатывал
обработать: обработать
обработка: Обработка обработки обработке
образ: образом
образец: образцом
обращаться: обращаться
обсудить: обсудим
общий: Общие общим общими
объединение: объединения
объект: объектов
объектный: объектно
объявить: объявить
обычный: обычными обычный
ограничение: ограничения
один: один
однако: Однако
однопоточный: однопоточного
ожидать: ожидаемой ожидает
ожидаться: ожидается
означать: означает
оказаться: оказаться
окружение: окружение
он: он
она: она её
они: Они им
оно: оно
оператор: Операторы
операция: операция операцию операции
оперировать: оперировать
описать: описать описаны
оповестить: оповестит
оповещение: оповещение
определение: Определение
определенно: определённо
определенный: определённым определённый определённого
определить: определить
определять: определяем
опровержимость: Опровержимость
организация: Организация
ориентировать: ориентированного ориентированных
основа: основе
основный: основном основная
особенно: особенно
оставлять: оставляют
остальной: остальная
отвечать: отвечают
отличаться: отличаться отличается
относиться: относящейся
отрицательно: отрицательно
отрицательный: отрицательным отрицательные
очень: очень
очистка: очистке очистка
ошибка: ошибок ошибки ошибках ошибку ошибка ошибке
ошибочный: ошибочной
пакет: пакетов Пакеты
память: памяти
паника: панике Паника панику
паниковать: паникует паниковать паниковал
параллелизм: параллелизм
параллельный: параллельного
параметр: параметра параметр параметров
перевод: Переводы
передавать: передаёт передавать передают
передаваться: передаются
передать: передали
передача: передачи
переменный: Переменные переменными
пересылка: Пересылка
перечисление: Перечисления Перечисление
перечислить: перечисленного
писать: писать пишете
побудить: побудит
поведение: поведения поведение
повлиять: повлиять
повторять: повторяя
поговорить: поговорим
подвергнуть: подвергнуть
подробнее: Подробнее
подсчет: подсчётом
подталкивать: подталкивать
подходить: подходит
позволять: позволяет
показывать: показывает
полагаться: полагаться полагается
поле: поле поля полей
полезный: Полезные
положительно: положительно
получать: получаем получает
получение: Получение
получить: получить
пользователь: пользователя пользователь пользователю
пользовательский: пользовательских пользовательского
поместить: поместить
помечаться: помечается
помочь: помочь
помощь: помощью
понимание: Понимание
понимать: понимает
понятно: Понятно
понятный: понятным
попросить: попросить
попытаться: попытаться
попытка: попытка попытки
поскольку: Поскольку
последовательность: последовательности
последствие: последствия
потенциально: потенциально
потенциальный: потенциальный потенциальную
поток: потока поток потоков потоками
потому: потому
потребоваться: потребуется
почему: почему
поэтому: Поэтому
появление: появления
правильный: правильное правильными правильным
превратить: превратив
превращение: Превращение
предел: пределами
предисловие: Предисловие
предлагать: предлагает
предположение: предположения предположение
прежде: прежде
прежний: прежнему
прекратить: прекратил
приватный: приватным
привести: привести
привет: Привет
призвать: призваны
прийти: пришла
приложение: Приложения приложении
пример: Пример примеры примерах примера
принимать: принимаете принимает
приниматься: принимается
принцип: принципами
принятие: принятие
причина: причину причина
проблема: проблемы проблемой проблеме проблем
провалиться: провалившийся
проверить: проверить проверенное
проверка: проверок проверку проверки проверка
проверять: проверяя проверять проверяли проверяет
программа: программы программу программе программа
программирование: программирования Программирование
программист: программисты программиста
продвинуть: Продвинутые
продолжение: продолжение
продолжить: продолжить
проект: проектами Проект проекта
проектирование: проектирования
производительность: производительности производительность
происходить: происходит происходить
пройти: прошёл
пропустить: пропущенные
просить: просил
противоречивый: противоречивые
прототип: прототипы прототипа
прототипирование: прототипирование
профиль: профилей
проходить: проходит
процесс: процессу
публикация: Публикация
публичный: публичный
пункт: пунктов
путь: Пути путей
пытаться: пытающийся пытаться
работа: Работа работы работу
работать: работала работают
рабочий: Рабочие
равный: равно
развить: разовьём
раздел: разделе
разделять: разделяемого
раздражительный: раздражительным
различный: различное
разный: разных
разобрать: разобрать
разработка: Разработка разработки
разрешить: разрешить
разумный: разумного
рассмотреть: рассмотрим
расти: растущими
расширение: Расширение
расширить: Расширенные
расширять: Расширяемый
реализация: Реализация
реализовать: реализуем
редакция: Редакции
рекомендоваться: рекомендуется
рефакторинг: Рефакторинг
решение: решение решения
решить: решить
риск: риску
руководство: Руководство
руководящий: руководящими
сам: самом
сбой: сбой
свой: своё свой своих своей своём
связать: связанных связанными
сделать: сделать сделала сделает
сервер: сервера сервер
сигнализировать: сигнализирует
сигнатура: сигнатурах сигнатуре
символ: символы
синтаксис: Синтаксис
синтаксический: синтаксический
система: систему системы
ситуация: ситуации ситуация
сказать: сказать
следовательно: следовательно
следовать: следует
следующий: следующего следующую
слишком: Слишком
слово: слова
случай: Случаи случае случаях случай случаев
смысл: смысла смысл
сначала: сначала
соглашение: соглашения
создавать: создаём создавать создающую
создаваться: создаётся создавался
создание: создание создании создания
создать: создать создадите
соображение: соображений
сообщать: сообщает
сообщение: сообщений сообщения
сообщить: сообщить
соответствовать: соответствовать
сопоставление: сопоставление
состояние: состоянием состоянии состояние состояний
состоять: состоит
список: списков списке
способ: способ способом способа способов способы
сравнение: Сравнение сравнением
среда: среды
срез: среза
срок: сроков
ссылка: Ссылки ссылок ссылками
ссылочные: Ссылочные
стандартный: стандартная стандартной
статус: статус
стоить: стоит
сторона: стороны
страшный: страшными
строка: строками строки строку строка
структура: структур структуры структуре структуру
существовать: существовало
сформировать: сформированные
счастие: счастью
так: так
также: Также
такой: такое таких такой такого такая Таким
текст: текста тексте
текущий: текущей
тело: теле
тема: Тем
теперь: Теперь
тест: тестов тесты тесте тест
тестирование: тестирование
тестировать: тестируемой
тип: Типы Тип типов типах типа
типаж: типажи
тот: том того то тех
точка: точки
точный: Точно
требование: требованиям
требовать: требующих
трейт: трейта трейтов трейт
трейты: трейты
убедиться: убедиться
уверить: уверены
увидеть: увидеть увидели
угадать: угадать
угадывание: угадывания
удобный: удобными
уже: уже
указание: указания
указатель: указатели указателями указатель
указывать: указывающий указывает указывающие
улучшение: улучшения Улучшение
умен: умён
уместно: уместно
умный: Умные умными умный
умолчание: умолчанию
упоминание: Упоминание
управление: управления Управление
управлять: Управляющие
условие: условии Условия условиями
успех: успех
устанавливать: устанавливать
установка: Установка
устранимые: Устранимые
утечка: утечке
утомительный: утомительной
уязвимость: уязвимостям
файл: файла файлов
финальный: Финальный
формат: формате
функциональность: функциональности функциональностью
функциональный: Функциональные
функция: Функции функциях функция функцию функций
характеристика: характеристики
хороший: хорошим хорошего лучше лучшей лучшим
хотеть: хотели хочет
хранение: Хранение
храниться: храниться
целесообразный: целесообразно
целое: целом
целый: целого
цель: цель
цикл: циклы цикла
цифра: цифр
часто: часто
частота: частоту
часть: часть
человек: человек
четкий: чёткие
число: числа число числами числом
чрезвычайно: чрезвычайно
чтение: Чтение
что: чего Что
чтобы: чтобы
шаблон: шаблона Шаблоны шаблон
экземпляр: экземпляров экземпляр экземпляра экземпляры
элемент: элемент элементов
этап: этапе
это: это этого
этот: этот эта этом этой этих этими эту
являться: является являются
явно: явно
язык: Язык языка языков
