автоматически: автоматически
автоматический: автоматических
аннотация: аннотации аннотацию
аннотировать: аннотировать
анонимный: анонимные
аргумент: аргументов
ассоциированный: ассоциированными Ассоциированные ассоциированным Ассоциированный ассоциированной ассоциированную ассоциированных
безбоязненный: Безбоязненный
библиотека: библиотеки
билд: билдов
бинарный: бинарных
более: более
больший: большую большая
большинство: большинство большинству
большой: больше
быть: будет будут быть есть было был были
валидация: Валидация
ваш: ваше вашего
введение: Введение
ввод: вводом
веб: веб
везде: везде
вектор: векторами
вернуть: вернёт
весь: Все всех
весьма: весьма
взаимодействие: взаимодействия
вид: виду
видимость: видимости
включать: включает
владение: владения владение
вместо: вместо
внесение: внесения
внешний: внешних
внимание: внимание
внутренний: внутренняя внутреннему внутреннего
возвращать: возвращать возвращаемый
возвращение: возвращения
возможность: возможности возможностей
возможный: возможно возможных
востребовать: востребованными
время: время времени
вручную: вручную
всегда: всегда
второй: второй вторую второго
вы: вы Вам
выбрать: выбрать
вывести: вывела
вывод: выводом вывод
выводимые: Выводимые
выводить: выводит
выглядеть: выглядеть
вызвать: вызвать
вызов: вызов вызове вызова
вызывать: вызываем вызывает вызываете
выполнение: выполнением Выполнение выполнения
выполнять: выполняем
выпуск: выпуска
выражаться: выражается
где: где
гипотетический: Гипотетическое
глава: главе главы
гласить: гласит
давать: Давайте
данные: Данных данные
дать: дать
два: двумя два двух две
двоеточие: двоеточие
действие: действия
делать: делаем делает делать
делегировались: делегировались
демонстрировать: демонстрирует
дерево: дереве
держать: держит
деталь: детали
длиннее: длиннее
добавить: добавить
добавление: добавления добавление
добавлять: добавляя
документация: документации
документирование: документирование
должный: должны должен должна
дополнительный: дополнительный
допускать: допускающих
доступ: доступа
другой: другие другого Другими другую другой
его: его
единица: единицах единиц
животное: животных
жизнь: жизни
завершение: завершение
зависеть: зависит
зависимость: зависимости
загадка: загадки
задействовать: задействованы
заимствование: заимствование
закодировать: закодированного
заменить: заменит
замыкание: замыкания
запись: Запись
заполнитель: заполнителей заполнитель заполнители заполнителя заполнителем
запуск: Запуск
затем: Затем
захватывать: захватывают
звездочка: звёздочками
здесь: здесь
знакомый: знакомым
знать: знаете знать знает
значение: значений значениями значения значение значениям
игра: игры
известный: известно
изменение: изменений
изменить: изменим
изменяемость: изменяемость
измерение: измерения
изучить: изучить
именовать: именованных
иметь: имеет иметь имеют имеем имеете имел
иметься: имеющийся
имя: именем имя именами имени
индекс: индексом
иногда: Иногда
инструмент: инструменты
информация: информации
исключаться: исключается
использование: Использование использовании использования
использовать: использующей использовать использующие используя используем использующим использовали используемому используете использованная использующих использует
использоваться: использоваться используются используется
исправить: исправить
итератор: итераторы итераторов итератор
итерироваться: итерируется
каждый: каждой каждый
какой: какие какую какой
качество: качестве
квалифицированный: квалифицированный
ключ: ключей
ключевой: ключевого Ключевые
книга: книги
когда: когда
код: кода код коде
коллекция: коллекции
команда: команд
командный: командной
комментарий: Комментарии
компилятор: компилятор компилятору компилятора
компиляция: компиляции
конкретный: конкретной конкретный конкретного конкретные
конструкция: конструкции Конструкция
контракт: контракта
конфиденциальность: конфиденциальностью
концепция: концепции концепцией концепциями
кортеж: кортежей кортежа кортеже
кортежный: кортежной кортежные
который: которые который которым которого которая котором которой которую которое которому
крейт: крейтов крейты крейта
куча: куче
лаконичный: Лаконичный
листинг: листинге Листинг
локальный: локальными локальным локальной
ломать: ломающих
любой: любого любую
макрос: Макросы
маленький: маленьких
менее: менее
менять: меняя
место: места
метод: метода методов метод методом методе методы методами
метр: метрах
мешать: мешает
миллиметр: миллиметрах
мир: Мир
многий: многие
многопоточный: многопоточного многопоточный
модуль: модулей
модульность: модульности
можно: можно
мочь: могут может можем могли можете могло
мы: Мы нам нас нами
мягкий: Мягкое
название: название
назвать: назвали назвать
называть: называют
называться: называется
найти: найден
наоборот: наоборот
напечатать: напечатает напечатать
написание: Написание
написать: написать
напоминать: напоминает
например: например
напрямую: напрямую
нарушение: нарушения
настраивать: настраиваете
настройка: Настройка
находиться: находятся находится
начать: начать
наш: нашего
небезопасный: Небезопасный
недостаток: Недостатком
некоторый: некоторые
немного: немного
необходимость: необходимости необходимость
неоднозначность: неоднозначности неоднозначность
непосредственно: непосредственно
несколько: несколько
нет: нет
неустранимый: Неустранимые
ничто: ничего
новый: нового Новый новым
нужный: нужно нужен нужны нужна
оба: оба обоих
обертка: обёртки
обертывание: обёртывание
обеспечение: обеспечения
область: областью область области
обобщение: обобщения обобщений
обобщенные: Обобщённые
обобщенный: обобщённым обобщённый обобщённого
обойти: обойти
оболочка: оболочкой оболочки
обрабатывать: обрабатывать
обработка: Обработка обработки
образ: образом
образец: образцом
обрамить: обрамлённое
обращаться: обращаться
обсуждать: обсуждали обсуждаемые
обсуждаться: обсуждается
общий: Общие общим общего общем
объединение: объединения
объект: объектов объект
объектный: объектно
объявить: объявлены
объявление: объявление объявлении
обычно: обычно
обычный: обычными
ограничение: ограничения ограничение
один: Одним один одно одного
одинаковый: одинаковых одинаковым одинаковыми
однако: Однако
однопоточный: однопоточного
означать: означает
окружение: окружение
он: он ему ним нем
она: она её
они: они им
оператор: Операторы операторов оператора операторами оператор
операция: операции
опираться: опирается
описать: описанные опишем
описывать: описывающее описывает
определение: Определение определениях определения определением
определенный: определённых определённую
определить: определить определят определён определили определены определена
определять: определять определяет определяющих
определяться: определяется
опровержимость: Опровержимость
опустить: опустить
организация: Организация
ориентировать: ориентированного ориентированных
основный: основных
остальной: остальной
отличный: Отличным
отображение: отображения
отсутствовать: отсутствовать
очистка: очистке очистка
ошибка: ошибок ошибки ошибках ошибку
пакет: пакетов Пакеты
память: памяти
параллелизм: параллелизм
параллельный: параллельного
параметр: параметр параметров Параметры параметра
первый: Первая первый
перевод: Переводы
перегружать: перегружать перегружаем
перегрузить: перегрузить
перегрузка: перегрузка перегрузки
передача: передачи
перейти: перейти
переключить: переключим
переменный: Переменные переменными
пересылка: Пересылка
перечисление: Перечисления
перечислить: перечисленные
печатать: печатает печатал печатать
печать: печать
писание: писание
писать: писать
поведение: поведения поведение
подробнее: Подробнее
подробно: подробно
подробный: подробному подробный
подсчет: подсчётом
позволить: позволить позволило
позволять: позволяют позволяет
познакомиться: познакомились
пока: пока
показать: показано показана
показаться: показаться
показывать: показывает показывая
поле: полей поле
полезный: Полезные полезен
полностью: Полностью
полный: полный полного
получать: получаем
получение: Получение
получить: получить получим получили
пользователь: пользователей
пользовательский: пользовательских пользовательский пользовательское
помогать: помогает
помочь: помочь
помощь: помощью
понимание: Понимание
понять: понять
попытаться: попытались
попытка: Попытка
посередине: посередине
поскольку: Поскольку
последний: последние
последовательность: последовательности
посмотреть: посмотрим
поток: потока поток потоков потоками
потому: потому
потребовать: потребовать
похожий: похожей похожа похож
почему: почему
поэтому: Поэтому
правило: правило
правильный: правильное
практика: практикой
превращение: Превращение
предисловие: Предисловие
предоставить: предоставить
предоставлять: предоставляем предоставляют
преобразование: преобразование
привести: привести
привет: Привет
приемник: приёмника
прийтись: пришлось
приложение: Приложения
пример: Пример примеров примером примера
принимать: принимает
приют: приюта
программа: программы программе
программирование: программирования Программирование
продвинуть: Продвинутые продвинутых
проект: проектами Проект проекта
проектирование: проектирования
производительность: производительности
произвольный: произвольные
происходить: происходит
профиль: профилей
проще: проще
прояснять: проясняет
публикация: Публикация
путь: Пути путей путём
пытаться: пытаемся
работа: Работа работы
работать: работает работать
рабочий: Рабочие
равный: равен
раз: раз
раздел: разделе
разделять: разделяемого
различный: различных
разница: разницу Разница
разный: разных разные
разработка: Разработка разработки
разработчик: Разработчики разработчикам
разрешаться: разрешается
разрешить: разрешить
рамка: рамках
рассматривать: рассматривать
рассмотрение: рассмотрению
рассмотреть: рассмотрим рассмотрели
расти: растущими
расширение: Расширение
расширить: Расширенные расширить
расширять: Расширяемый
реализация: Реализация реализации реализацию реализаций
реализовать: реализованы реализовать реализован реализуя реализовали реализуем реализованный реализующих реализует реализованного реализующие реализованную реализующего реализовал реализующая реализуют реализована
реализоваться: реализуется
реализовывать: реализовывать
реализующий: реализующий
редакция: Редакции
редкий: реже
редко: редко
рефакторинг: Рефакторинг
решение: решением
свой: своё своих
связать: связанных связанными Связанные связанного связанной связанную
связывать: связывают
сделать: сделать
себя: себя себе
сервер: сервера сервер
сигнатура: сигнатурах
символ: символы
символизировать: символизирует
синтаксис: Синтаксис синтаксиса
сирота: сироты
система: системой
ситуация: ситуаций
сказать: сказать
складывать: складывать складывает складываете
скобках: скобках
скомпилировать: скомпилирована
следующий: следующее следующим
слово: слова словами
сложить: сложить
сложный: сложные
случай: случаях
собака: собак
собственный: собственные
содержать: содержащий содержит
создавать: создавать создаём
создаваться: создаётся
создание: создание создания
создать: создать
сокращенно: сокращённо
сообщение: сообщений сообщение
соответствовать: соответствовать
соответствующий: соответствующие
сопоставление: сопоставление
состояние: состоянием
специальный: специальных
список: списков список
способ: способы
сравнение: Сравнение
среда: среды
срез: среза
срок: сроков
ссылка: Ссылки ссылок ссылками
ссылочные: Ссылочные
стандартный: стандартной стандартное
становиться: становятся
строка: строками строки
структура: структур структуры структуру структура структуре
супер: супер
существовать: существующего существующий существующему существующей существует
так: Так
также: также
такой: такое таким Такой таких
там: там
текст: текста
текущий: текущей
теперь: Теперь
термин: термин
тест: тестов тесты
тестирование: тестирование
техника: Техника техники
тип: Типы Тип типов типами типа типом
типаж: типажи типажом типажа типаж типажей типаже типажу
тогда: Тогда
тоже: тоже
тонкий: тонкое тонкой
тот: том то тем тех те
точно: точно
требование: требования
требовать: требует требуемое
требоваться: требуется
трейт: трейта трейтов трейт
трейтами: трейтами
трейты: трейты
три: трёх
угловой: угловых
уже: уже
указание: указания Указание
указатель: указатели указателями указатель
указать: указать укажем указав указали
указывать: указывая указывает указывать указываем
указываться: указывается
улучшение: улучшения Улучшение
умный: Умные умными умный
умолчание: умолчанию
упоминать: упоминали
управление: управления Управление
управлять: Управляющие
успешно: успешно
установка: Установка
устранение: устранения
устранимые: Устранимые
устранить: устранить
устранять: устраняет
утечка: утечке
ухудшение: ухудшения
файл: файла файлов Файл
финальный: Финальный
функциональность: функциональности функциональность
функциональный: Функциональные
функция: Функции функцию функцией функций
характеристика: характеристики
хороший: хорошей
хотеть: хотим хотели хотите хочет
хранение: Хранение
хранить: хранящие
цель: цели цель
цикл: циклы
часто: часто
частый: чаще
часть: части частью часть
чтение: Чтение
что: чего Что
чтобы: Чтобы
шаблон: шаблона Шаблоны шаблон
щенок: щенков щенками
эквивалентно: эквивалентно
экземпляр: экземпляров экземпляра экземпляр
элемент: элемент элементов элементы
это: это
этот: эти этой этого этими Этот этом эту
являться: является являющиеся являющейся являющуюся являются
явный: явный
язык: Язык языка языков
