автоматический: автоматических
адрес: адресу
аннотация: аннотация
аннотировать: аннотируем аннотировать
анонимный: анонимные
аргумент: аргументов аргумента аргументы аргумент аргументами аргументом
безбоязненный: Безбоязненный
библиотека: библиотеки библиотеку
билд: билдов
бинарный: бинарных
более: более
бывать: бывает
быть: есть будет быть были был
валидация: Валидация
ваш: вашей
введение: Введение
ввод: вводом
вводить: вводим
веб: веб
вектор: векторами вектор векторе вектора
весь: Все
вещь: вещи
вид: видов
видимость: видимости
видно: видно
владение: владения владение
вложить: вложена вложенной
вместо: вместо
внимание: внимание
внутренний: внутренняя
возвращать: возвращает
возможность: возможности возможностей возможность
возможный: возможно
воспринимать: воспринимать
время: время
второй: Вторым второй
входить: входящая
вы: вы вам
вывести: вывести
вывод: выводом
выводимые: Выводимые
выводить: выводим
выводиться: выводятся
выдавать: выдаёт
вызвать: вызвать вызовет вызваны
вызов: вызов вызова
вызывать: вызываем
выносить: выносить
выполнение: выполнением Выполнение выполнения выполнении
выпуск: выпуска
где: где
генерировать: генерируют
глава: главе главы
давать: давайте
далее: Далее
данные: Данных данные
данный: данный
два: два две двумя двух
двоичный: двоичного
двойной: двойного
двусмысленно: двусмысленно
действие: действия
дерево: дереве
дефис: дефиса
добавить: добавим
добавление: добавления добавление добавлением
допускать: допускающих
достаточный: достаточно
доступ: доступ
другой: другие
его: его
жизнь: жизни
завершение: завершение
зависимость: зависимости
загадка: загадки
задача: задача
заимствование: заимствование
заключение: заключение
закодировать: закодированного
замыкание: замыкания
занимать: занимает
запись: Запись
запускать: запускать
запустить: запустить запустим
заставить: заставить
затем: затем
захватывать: захватывают
здесь: здесь
знать: знать
значение: значений значениями значения значение значениям
значить: значит
игра: игры
изменить: изменить
изменяемость: изменяемость
изучать: изучаете
иметь: иметь
имя: имени имя
индекс: индекса
инструкция: инструкции
инструмент: инструменты
искать: искать ищем
искомый: искомой
использование: Использование использованием
использовать: использующей использовать используем использован
использоваться: использоваться
используйте: используйте
итератор: итераторы итераторов итератор итераторах итератора итератором
каждый: каждой
какой: какой какую
качество: качестве
ключ: ключей
ключевой: ключевого Ключевые
книга: книги
когда: когда
код: кода код
коллекция: коллекции коллекцию коллекций
команда: команд команды
командный: командной
комментарий: Комментарии
консоль: консоль
консольный: консольного
конструкция: конструкции Конструкция
конфиденциальность: конфиденциальностью
концепция: концепции концепцию
корректность: корректности
который: которые которое котором которая который которой которым которую
крейт: крейтов крейты крейта
куча: куче
лаконичный: Лаконичный
легко: легко
листинг: Листинге Листинг
любой: любые
макрос: Макросы макроса
менее: менее
место: места
метод: метода метод
мир: Мир
многий: многих
многопоточный: многопоточного многопоточный
модуль: модулей модуль модуле
модульность: модульности
момент: момент
мочь: могут может мог можем могли
мы: Мы нам
мягкий: Мягкое
название: названием название
назвать: назовём
написание: Написание написанием
например: например
настройка: Настройка
начать: начать
начинаться: начинаются
наш: нашего наше нашу нашей
небезопасный: Небезопасный
недействительный: недействительный
недопустимый: недопустимый недопустимые
некоторый: Некоторые некоторыми
необходимый: необходимо
неустранимый: Неустранимые
низкий: ниже
новый: новый
нужный: нужно нужная нужна нужны
обеспечение: обеспечения
область: областью область области
обобщенные: Обобщённые
обрабатывать: обрабатывать
обработка: Обработка обработки обработку
образ: образом
образец: образцом
обратите: Обратите
обсуждать: обсуждали
общий: Общие общим
объединение: объединения
объект: объектов
объектный: объектно
обычно: обычно
обычный: обычными
один: один одна
однопоточный: однопоточного
оказываться: оказывается
окружение: окружение
он: ему него
она: ей
они: их ними они
оператор: Операторы
описать: описано
определение: Определение
определенный: определённую
опровержимость: Опровержимость
организация: Организация
ориентировать: ориентированного ориентированных
остальной: остальных
отладочный: отладочного
отличаться: отличаются
отличный: Отлично
очень: очень
очистка: очистке очистка
ошибка: ошибок ошибки ошибках
ошибочный: ошибочными
пакет: пакетов Пакеты
память: памяти
паника: панику
параллелизм: параллелизм
параллельный: параллельного
первый: Первая первой первое Первый
перевод: Переводы
передавать: передаём
передать: переданных переданные
передача: передачи
переменный: Переменные переменными переменных переменную
пересылка: Пересылка
перечисление: Перечисления
печатать: печатаем
печать: печать
писать: писать
платформа: платформы
поведение: поведения поведению поведение
подробнее: Подробнее
подробно: подробно
подстрока: подстроки
подсчет: подсчётом
позволять: позволяет
позволяя: позволяя
поздний: Позже
поиск: поиска
пока: Пока
полезный: Полезные
получение: Получение
получить: полученные получить
пользователь: пользователь
пользовательский: пользовательских
помещать: помещаем
помочь: помочь
помощь: помощью
понадобиться: понадобится
понимание: Понимание
попробовать: Попробуем
поработать: поработаем
последовательность: последовательности
последующий: последующий
потенциальный: потенциальными
поток: потока поток потоков потоками
потому: потому
поэтому: поэтому
правильный: правильных
превратить: превратить
превращение: Превращение
предисловие: Предисловие
предназначить: предназначены
предоставлять: предоставляет
представить: представленный
привести: привести
привет: Привет
приложение: Приложения приложение
пример: Пример
принимать: принимать принимает
принятие: Принятие
принять: принят
проверка: проверки
программа: программы программу программа программе программам
программирование: программирования Программирование
продвинуть: Продвинутые
проект: проектами Проект проекта
проектирование: проектирования
проигнорировать: проигнорируем
произвести: произведённые
производительность: производительности
простота: простоты
профиль: профилей
псевдоним: псевдоним
публикация: Публикация
путь: Пути путей путь
работа: Работа работы
работать: работать работает
рабочий: Рабочие
разделять: разделяемого
различать: различать
разный: разных
разработка: Разработка разработки
распечатать: распечатать
распечатка: распечатки
рассмотреть: рассмотрим
расти: растущими
расширение: Расширение
расширить: Расширенные
расширять: Расширяемый
реализация: Реализация
реализовать: реализуем
редакция: Редакции
редко: редко
рекомендоваться: рекомендуется
рефакторинг: Рефакторинг
решить: решили
родительский: родительский
сам: сами сам
свой: своё
связать: связанных связанными
сгенерировать: сгенерированная
сделать: сделаем
сейчас: сейчас
сервер: сервера сервер
серия: серию
си: Си
символ: символы символ
синтаксис: Синтаксис
система: системе
ситуация: ситуациями ситуацию
следующий: следующие следующими
слово: слова
сложнее: сложнее
случай: случаях
сначала: Сначала
собирать: собирать Собираем
содержать: содержать содержит содержащие содержащий
создаваться: создаётся
создание: создание создания
создать: Создадим создать
сообщение: сообщений сообщениях
соответствовать: соответствовать соответствует
сопоставление: сопоставление
состояние: состоянием
сохранение: Сохранения
сохранить: сохраним сохранены
сохранять: сохранять
список: списков списка
сравнение: Сравнение
сразу: сразу
среда: среды
срез: среза
срок: сроков
ссылка: Ссылки ссылок ссылками ссылку
ссылочные: Ссылочные
стандартный: стандартную
строка: строки строками строку строке строк строка
структура: структур структуры
существовать: существующие
так: так
такой: такое Таким
текст: текста
текущий: текущем текущий
теперь: Теперь
тест: тестов тесты
тестирование: тестирование
тип: Типы Тип типов типа
типаж: типажи
тот: То того
требоваться: требуется
трейт: трейта трейтов трейт
трейты: трейты
удобный: удобно
уже: уже
указание: указания
указатель: указатели указателями указатель
указать: указать указанным
улучшение: улучшения Улучшение
умный: Умные умными умный
управление: управления Управление
управлять: Управляющие
уровень: уровня
установка: Установка
устранимые: Устранимые
утечка: утечке
файл: файла файлов файлу Файл
финальный: Финальный
функциональность: функциональности
функциональный: Функциональные
функция: Функции функция функцию функций
характеристика: характеристики
хотеть: хотим хотите
хранение: Хранение хранения
цель: целей
цикл: циклы
часто: часто
часть: частях
читать: читать
чтение: Чтение чтения
что: чего Что
шаблон: шаблона Шаблоны шаблон
экземпляр: экземпляров
элемент: элемент элементов элементы
это: Это этого
этот: эту Эта этой этих
юникод: Юникод Юникода
являться: является
явно: явно
язык: Язык языка языков
