адрес: адресу
альтернатива: альтернативу
безопасность: безопасности
библиотека: библиотеке библиотеки
более: более
будущее: будущем
буфер: буфера
быть: есть было быть будет были
вариант: варианта вариант
ваш: вашем вашего вашу вашей ваш
везде: везде
вектор: векторе вектора вектор вектору
вернуть: вернуть
вернуться: вернёмся
версия: версии
весь: всё всех
вещь: вещи
включать: включать
включить: включены
вниз: вниз
возвращать: возвращать
возможность: возможность возможности
возможный: возможно
возникновение: возникновении
возникнуть: возникла
восстановить: восстановить
второй: вторая
вы: вы вам вами
вывод: вывод вывода выводе
выводить: выводит
вызвать: вызвать вызвали вызовет вызваны
вызов: вызова вызовов вызов вызовом
вызывать: вызывает вызываем вызывать вызывала
вызываться: вызывается
выполнение: выполнения выполнение выполнению
выполнить: выполнен
выполняться: выполняющееся
выше: выше
выяснить: выяснить
где: где
генерировать: генерируют
глава: главы
говорить: говорит
давать: Давайте
далее: далее
данные: данных данные
два: два двух
действие: действия действие
делать: делать
демонстрация: демонстрации
диапазон: диапазона
добавить: добавьте
должный: должна должно должен должны
допустимый: допустимого
доступ: доступ доступа
другой: других другой Другие
его: его
завершать: завершают завершает
зависимость: зависимости
запаниковать: запаниковала запаникует
запрашивать: запрашивать
запуск: запуске
заставить: заставить
защитить: защитить
здесь: Здесь
злоумышленник: злоумышленник
значение: значений значение значениями
иметь: имеет иметь
имя: имя
индекс: индексу индекса индекс индексом индексов
индексирование: индексирование
иногда: Иногда
информация: информацию информацией
исполняемый: исполняемый
использование: Использование использовании
использовать: использовала использовать используемые использующих
исправление: исправления
исправлять: исправляемых
исследование: исследование
источник: источник
исходный: исходном
итог: итоге
каждый: каждой
какой: какая какой какое какими
когда: когда
код: коде кода код кодом
компьютер: компьютера
конец: конца
конечный: конечном
который: которое которую который которые которая которого
крейт: крейты
легче: легче
листинг: листинге Листинг листинга
любой: любое
макрос: макросом макрос макроса
маленький: маленьким
манипулировать: манипулировать
массив: массиву
менее: менее
место: место месте места
много: много
мочь: можете мог можем может могут
му: му
мы: мы нас нам
называться: называется
написать: написанных написали
например: например
напрямую: напрямую
насколько: насколько
находиться: находится
начать: начать
начинать: начинает
начинаться: начинается
наш: нашем нашей нашего наш нашим наших наша
неверный: неверный
немедленный: немедленного
неопределенный: неопределённому
несмотря: несмотря
неустранимый: Неустранимые
низкий: ниже
ничто: ничего
номер: номер
нужный: нужно
нуль: нуля
оба: обоих
обнаружить: обнаруженной
обработка: обработки
образ: образом
обратно: обратно
обратный: обратный обратную обратной Обратная
обращение: обращение
обсудить: обсудим
обсуждение: обсуждению
означать: означающий
окружение: окружения
он: него он
операционный: операционной
определенный: определённой
основной: основной
остановить: остановит
ответ: ответ
отказаться: откажется
отладка: отладки
отличаться: отличаться
отображать: отображать
отследить: отследить
очистить: очищена
очистка: очистку очистка очистки
очищать: очищает
ошибка: ошибки ошибке ошибок
память: Память памяти
паника: панику паника паники панике
паниковать: паникует
первый: Первая
передавать: передаёте
перейти: перейдём
переключиться: переключиться
переменный: переменной переменную переменная
плохой: плохие
поведение: поведению поведение
поделать: поделать
подобный: подобный
подробно: подробно
пока: пока
показывать: показывает
получить: получить получите
помощь: помощью
попробовать: попробуем
попытка: Попытка попытке
последний: последних
посмотреть: посмотрим
потому: потому
появляться: появляется
практика: практике
предел: пределами пределом
предлагать: предлагаем
предоставлять: предоставляет
представить: представленного
прервать: прервать
прерывание: прерывания
прерывать: прерывать
привести: привели приведён приведёт привести
пример: пример примере
принадлежать: принадлежит
причина: причиной
проблема: проблему проблема
программа: программе программы программа программу
продолжить: продолжить
проект: проекте
произойти: произойти
происходить: происходят происходит
простой: простой
проход: проход
процесс: процесс
прочесть: прочесть
прочитать: прочитать
путь: путём
пытаться: пытается пытаемся
пятый: пятый
работа: работу работы
работать: работает
равный: равно
раздел: раздел разделе
размер: размера
ранее: ранее
раскрутка: раскрутки
раскручивать: раскручивает Раскручивать
рассмотреть: рассмотрим
рассчитать: рассчитал
режим: режиме
релиз: релиза
род: рода
сверху: сверху
сгенерировать: сгенерированная
сделать: сделать
символ: символ символы
система: системой системы
ситуация: ситуации
следовать: следует
следующий: Следующая
случай: случаях случае
совсем: совсем
содержаться: содержащееся
создавать: создаёт
сознательно: сознательно
сообщение: сообщение сообщения
соответствовать: соответствовало
состоять: состоит
список: список
способ: способа способ
среда: среды
стандартный: стандартной
стать: стало
стек: стек стека стеку
сторонний: стороннем сторонней
строка: строках строка строке строки строк строками строку
структура: структуры
существовать: существует
считать: считал
так: так
также: также
такой: таким такого
там: там
тип: тип
тогда: тогда
тот: Тем то том тому того
точка: точки
трассировка: трассировку трассировки трассировка
тут: Тут
увидеть: увидите увидим
указать: указанная
указывать: указывает
умолчание: умолчанию
упоминание: упоминанием
упс: упс
установить: установить установлена
установка: установки
уязвимость: уязвимостям уязвимостей
файл: файл файла файлах файлов
флаг: флага
функция: функции функций
хотеть: хотите хотим
хранение: хранения
храниться: хранится
часть: частью часть
читать: читать
чтение: чтением
что: что
чужой: чужого
элемент: элементу элемента элемент
это: этим это этого
этот: этих этот этом этой этому Эти
являться: является являются
явный: явного
язык: языке языках
