более: более
большинство: Большинство
быть: будет
ваш: ваш вашу
весь: всего
вид: вида
возврат: возврате
возможность: возможность
возникновение: Возникновение
всегда: всегда
встречать: встречает
вы: вы
вызов: вызов
выполнение: выполнения выполнение
гарантируя: гарантируя
глава: глава
граница: границ
группироваться: группируются
два: две два
действие: действия
делать: делает
дефект: дефектов
доступ: доступа
жизнь: жизни
значение: значений
идти: идёт
иметь: имеет
исключение: исключения исключений
использовать: используя
исправимый: исправимые исправимой исправимых
исправить: исправить
категория: категории
код: код коде
который: которых который
макрос: макрос
массив: массива
механизм: механизмы
многий: многих
мы: мы
надежный: надёжной
надлежащий: надлежащим
найти: найден
например: например
неисправимые: неисправимые
неисправимый: неисправимую
некоторый: некоторые
немедленно: немедленно
необрабатываемый: необрабатываемую
нет: нет
нужный: нужно
оба: оба
обеспечение: обеспечения
обнаружить: обнаружите
обрабатывать: обрабатывают обрабатываемых
обработать: обработаете
обработка: Обработка обработки
образ: образом
одинаково: одинаково
он: он
они: их
операция: операцию
основный: основные
останавливать: останавливает
остановить: остановить
ошибка: ошибок ошибки ошибку
повторить: повторить
пользователь: пользователю
попытаться: попытаться
попытка: попытка
потом: потом
поэтому: поэтому
предел: пределами
предпринять: предприняли
прежде: прежде
признать: признали
принятие: принятии
проблема: проблеме
программа: программ программу программа
программный: программного
производственный: производственной
развернуть: развернёте
различать: различают
рассказать: расскажет
рассмотреть: рассмотрим
реальность: реальность
решение: решения
ряд: ряд
свой: свой
симптом: симптомами
ситуация: ситуаций
скомпилировать: скомпилирован
скорый: скорее
следовать: следует
случай: случаях случае
сначала: Сначала
сообщить: сообщить
среда: среде
суровый: суровая
так: так
такой: такой такие
тип: тип
тот: то того том
требование: требование
требовать: требует
учитывать: учитывать
файл: файл
функция: функций
ход: ходе
хотеть: хотим
что: что
это: это этого
этот: эти эта
являться: являются
язык: языков
ячейка: ячейке
