авто: авто
автоматически: автоматически
альтернатива: Альтернативы
аналогично: аналогично
аргумент: аргумент
базовый: базовым
библиотека: библиотеки библиотека
более: более
больше: больше
больший: больших
большинство: большинство
большой: большого
быстрый: быстрого
быть: будет быть было есть был
вариант: варианта вариантов варианты Вариант вариантом варианте
ваш: вашем ваше вашей ваших
вверх: вверх
вернуть: вернуть вернёт вернуло
вернуться: вернуться Вернётся вернёмся
вести: вели
весь: Все всю всей всех
ветвь: ветвь
ветка: ветках ветку ветка
вид: вид
видимость: видимости
включать: включает
вложить: вложенных
внешний: внешнего
внимание: внимание
внутренний: внутреннего внутренняя внутреннем
внутри: внутри
возврат: возврата возврат возвратом
возвратить: возвращено возвращена возвращён
возвращаемое: возвращаемое
возвращать: возвращает возвращаемый возвращаемых возвращаемого возвращаем возвращали возвращающая возвращаемом возвращать возвращают возвращаемым возвращающий
возвращаться: возвращается
возможно: возможно
возможность: возможность возможности
возможный: возможных
возникновение: возникновения
возникнуть: возникли
вопросительный: вопросительного
воспользоваться: воспользуемся
время: время времени
вручную: вручную
всегда: всегда
вспомните: Вспомните
вспомогательный: вспомогательных
второй: второй Вторая
вход: входа
входить: входят
вы: Вы вам вас
выбирать: выбирает
выбрать: выбрали
выводиться: выводится
выглядеть: выглядит
вызвать: вызовем вызвать вызовет вызвал вызван
вызов: вызов вызова вызовов вызове
вызывать: вызывать вызываем вызывает вызывающий вызываемый
вызываться: вызывается
вызывающий: вызывающему
выйти: выйдет
выполнение: выполнение выполнении выполнения
выполнить: выполним выполнит выполнить
выполниться: выполнится
выражать: выражает
выражение: выражение выражения выражении выражений
выразить: выразить
выход: выхода выходе
выходить: выходить
где: где
глава: главы Главе Главу
говорить: говорит
гораздо: гораздо
давать: Давайте даёт даём
данный: данное Данная данный данную данной
дать: дать
два: два
действие: действий действия действии
делать: делает делать
дело: деле
демонстрировать: демонстрирует
дескриптор: дескриптору дескриптор дескриптора
деталь: детали
диктовать: диктует
директория: директории
длинный: длинный
добавить: добавили добавлен
добавление: добавления
добавлять: добавляем добавляет
довольно: довольно
документация: документации
должный: должна должен
дописать: дописать
дополнительный: дополнительную дополнительного дополнительной
допускать: допускающих
досрочный: досрочного
достаточно: достаточно
доступ: доступ доступа
другой: Другая другой другое других другие
ее: её
еще: ещё
завершаться: завершается завершаются
завершить: завершить завершённые
завершиться: завершиться завершился завершится
зависимость: зависимости
задать: заданного
задача: задач задачу
заключаться: заключается
закончиться: закончиться
замена: Замена
заменить: заменит
заметьте: Заметьте
замыкание: замыканиях замыканий
запись: записи
заполнить: заполнен
запустить: запустим
затем: затем
захотеть: захотите
здесь: Здесь
знак: знака
знать: знать
значение: значения значение значением значениями значениям значений
избавиться: избавиться
известный: известен
извлекать: извлекает
изменить: изменить изменили
измениться: изменилась
изменяемый: изменяемой
изучить: изучите изучить изучили
иметь: имеющее имеет иметь
иметься: имеется
импорт: импорту
имя: именем имя
иногда: Иногда
инструмент: инструментом
интересовать: интересует
интерпретация: интерпретация
информация: информацию информации информацией
исполнять: исполняемых исполняемый Исполняемые
исполняться: исполняться
использование: Использование использованием использованию использовании
использовать: использовали использовать используемый используемое используя используем использовало используете
использоваться: используются используется использоваться
исправимые: Исправимые
исправить: исправить
исправление: исправления
источник: источника
итак: Итак
итератор: итератор итератора итераторе
итог: итоге
какой: какая какими какие какой
качество: качестве
ключевой: ключевое
когда: Когда
код: код коде коду кода
количество: количества
компилировать: компилируем
компилироваться: компилироваться
компонент: компоненты
конец: конце конец
конечно: Конечно
конкретный: конкретным
контроль: контроля
короткий: коротким короткий
короче: короче
корректный: корректной
который: которое которая которые которого который которых которой которую котором
критичный: критичными
лаконичный: лаконичным Лаконичные лаконичный
листинг: листинге Листинг листинга
логика: логику логики
любой: любой любым любое любые
макрос: макрос макроса
место: месте
метод: метод методах методы метода методов
многие: Многие
многий: многих
много: много
многое: многое
многословный: многословным
множество: множество
можно: можно
момент: момент
мочь: может можем могут можете мог могла могли
мы: мы нас нам
найти: найти
намерение: намерение
наоборот: наоборот
написание: написания
написать: написать написали написана написанные
например: например
настолько: настолько
находить: находит
находиться: находится
начало: начало
начать: начнём
начинаться: начинается
наш: нашей Наше наша
неверный: неверным
недостаточно: недостаточно
независимо: независимо
ненулевой: ненулевым
необходимость: необходимости
необходимый: необходима Необходимо
непосредственно: непосредственно
несмотря: Несмотря
несовместимый: несовместимым
нет: нет
неудача: неудачу неудачей неудаче неудачи
новый: новый новую новой
нужный: нужно нужна нужен
оба: обеих
обернуть: обёрнутое
область: область
облегчить: облегчить
обобщенный: обобщённого обобщённые
обрабатывать: обрабатывает обрабатываем обрабатывал обрабатывать
обрабатываться: обрабатываться
обработка: обработка обработки обработкой обработке обработку
образ: образом
образец: образца
обратите: Обратите
обратиться: Обратитесь
обратно: обратно
обсудить: обсудим обсудили
объект: объектом объектов
объяснить: объяснить
обычно: обычно
ограничение: ограничений ограничения
один: один одной одного
однако: Однако
ожидаться: ожидается
означать: означает
оказаться: оказалось
он: него его он нему
она: ней она
оператор: оператор оператора оператору оператором
операция: операций операция
описание: описание описания
определенный: определённую
определить: определено определены определённый определим определён определили
особенный: особенная
оставаться: остаётся
останавливать: останавливать
остановить: остановить
остановка: остановки
остаться: останется
ответвление: ответвление
отдельный: отдельные
открывать: открывает
открытие: Открытие открытия
открыть: открыть
отладка: отладки
отличаться: отличаются
отличный: отличное
относиться: относится
отслеживание: отслеживание
отсутствие: отсутствия отсутствии
очень: очень
очистить: очистить
ошибка: ошибки ошибка ошибке ошибок ошибкой ошибку ошибках
паника: паники
паниковать: паникует
параметр: параметрами параметры параметр
первый: Первый первой первую первое первая
передавать: передаёт передаём
передать: передано
передача: передачи
переменный: переменной переменную
перенести: перенесли
перечисление: перечисление перечисления
писать: писать пишете
поведение: поведение
поговорить: поговорим
подробно: подробно
подходить: подходит
подходящий: подходящим
позволять: позволяющий позволяет позволяя
пойти: пошло
пока: Пока
показать: показанное показана покажем показано
показывать: показывает
полезный: полезным полезно
получать: получаем получает
получение: получения получение
получить: полученного получит полученный получим получить
пользователь: пользователя
пользовательский: пользовательский
пользоваться: пользуясь
помогать: помогают
помощь: помощью
попадать: попадаем
попытка: попытке Попытка
пора: пор
порядок: порядке
поскольку: Поскольку
после: После
последний: последнее последний
последующий: последующего
посмотреть: посмотрим
потенциальный: потенциального
потерпеть: потерпеть потерпит
потому: потому
похоже: похоже
похожий: похожий
почему: почему
почти: почти
поэтому: поэтому
появиться: появиться
появление: появления
правильный: правильная
право: прав
предоставление: предоставлением
предоставлять: предоставляет
предположение: предположение
предпринять: предпринять
представлять: представляет представляющие
прежний: прежнему
преобразование: преобразования преобразование
преобразовать: преобразует
преобразоваться: преобразуется
преобразовывать: преобразовывать
препятствовать: препятствующих
привести: привести приведён
прием: приём
прийтись: пришлось
пример: примеру примере пример
примитивный: примитивным
принимать: принимает
присвоить: присвоим
причина: причин причине причинам
проблема: проблем проблемами проблемы
проброс: Проброс проброса
проверить: проверить
проверка: проверка
программа: программы программа программ
продолжать: продолжает
продолжая: Продолжая
продолжить: продолжит
произойти: произойти произошла произойдёт
происходить: происходит
простой: простым
проходить: проходят
прочесть: прочтён
прочитать: прочитаете прочитала прочитать
проще: проще
прямо: прямо
пустой: пустой пустая
пытаться: пытаемся пытается
работа: работе работу
работать: работает
рабочий: рабочем
равный: равно
раз: раз
раздел: раздел раздела разделе
различный: различных различные
размещать: размещает
разница: разница
разный: разных разными разным разные
разрешение: разрешения
разрешить: разрешено
ранний: ранний раннего ранним раньше
расположить: расположенное
распространение: распространение
распространить: распространена распространённая
распространять: распространяем
рассматривать: рассматривать
рассмотреть: рассмотренным рассмотрим
реализация: реализации реализация реализацию
реализовать: реализованный реализующий реализовать реализующие
результат: результатом
результирующий: результирующим
рекомендовать: Рекомендуем
решить: решили решить
сам: Само самой самом
самый: самое
сбой: сбой сбоя сбоев сбое сбою
свой: свою
сделать: сделано сделаем сделать
себя: собой себя
сей: сих
сейчас: сейчас
середина: середине
сигнатура: сигнатура
символ: символ символов символы
синтаксис: Синтаксис
ситуация: ситуацию ситуациях ситуации
скомпилировать: скомпилирован
следовать: следует
следующий: следующим следующее
слово: слово
случай: случае случай случаях случаев
смешивать: смешивать
смысл: смысл
сначала: сначала
снова: снова
собственный: собственных
совместимый: совместим совместимым
соглашение: соглашением
содержать: содержащий содержащим содержит содержащее содержащего
содержимое: содержимое
соединить: соединили
создавать: создаёт
создание: создания создание
создать: создать создан
сократить: сократить
сокращение: Сокращение
сообщение: сообщение сообщения сообщении
сообщить: сообщить
соответствовать: соответствует
соответствующий: соответствующим
сопоставление: сопоставление сопоставления
сопоставлять: сопоставлять
специализированный: специализированное
специфический: специфических
способ: способ способов способами способы способом
сработать: сработала
сразу: сразу
срез: среза
стандартный: стандартной стандартное стандартная
становиться: становится
столкнуться: столкнётся
строй: строя
строка: строке строку строки строк строкой строка строках
структура: структура
существовать: существовать существует существуют
схема: схема
счастие: счастью
считать: считать
так: Так
также: Также
такой: Такой таким такое такая такие
там: там
текст: текста
текущий: текущей
тело: теле Тело
теперь: теперь
тип: Типы типа тип типу Типом типе типов
тоже: тоже
тот: то том того той ту те тем тому
точка: точка
точно: точно
трейт: трейте трейт трейта
увидеть: увидим
угода: угоду
удаться: удался удалось
удобный: удобную
уже: уже
узнавать: узнаете
указать: указать указав
указывать: указывать указывает
умолчание: умолчанию
универсальный: Универсальный
упоминаться: упоминалось
упростить: упростить
условие: Условие
успех: успеха успехе успехах
успешно: успешно
успешный: успешного успешным
файл: файл файла файлу файле файлы файлов
файловый: файлового файловый
фрагмент: фрагмент фрагмента
функциональность: функциональность
функция: функции функцию Функция функцией функциях
хороший: хорошего
хорошо: хорошо
хотеть: хотим хочет
целый: целые целое
цепочка: цепочку Цепочка
часть: часть
число: числа число
читать: читать читает
чтение: чтения Чтение
что: что
шаблон: шаблона
шаблонный: шаблонный шаблонного
экземпляр: экземпляр экземпляром экземпляра
элемент: элемент
эргономичный: эргономичный
это: это этого этим этому
этот: эти Эту этот этом этой Эта этими этих
являться: являются является
явно: явно
язык: языка
