абстракция: абстракцию абстракции абстракций абстракция
автоматически: автоматически
автоматический: автоматических автоматическую
адрес: адресу адрес адреса
альтер: альтер
анализ: анализ
анализатор: анализатор
аннотация: аннотацию аннотации
анонимный: анонимные
аппаратный: аппаратное
аргумент: аргументов аргумента
ассемблер: ассемблера
безбоязненный: Безбоязненный
безопасно: безопасно
безопасность: безопасность безопасности безопасностью
безопасный: безопасной безопасном безопасную безопасный безопасные безопасных безопасного безопасным
библиотека: библиотеки библиотеку
билд: билдов
бинарный: бинарных бинарный
благодарный: благодарны
блок: блок блока блоков блоки блоке блоками
больший: большую
большой: больше
брать: берём берет
быть: быть будет есть будут будете будем Будьте были
важный: Важно
валидация: Валидация
ваш: вашей ваши вашему
введение: Введение
ввести: введём
ввод: вводом
веб: веб
вектор: векторами
верный: верный
вероятный: вероятному
веский: веских
весь: Все всех всё всю
взаимодействие: взаимодействие взаимодействия
вид: виду
видимость: видимости
включать: включают
включая: включая
владение: владения владение
владеть: владеем
вместо: вместо
внесение: внесение
внешний: внешнего внешних внешнему внешняя
внимание: внимание
внутренний: внутренняя
внутри: внутри
возвращать: возвращаем возвращает
возможность: возможности возможностей Возможность возможностям
возможный: возможную возможно
возникать: возникают
возникнуть: возникнуть
время: время временем
вручную: вручную
всегда: всегда
вспомним: вспомним
второй: Второй
вы: вам вы вас
вывести: вывести
вывод: выводом
выводимые: Выводимые
выглядеть: выглядят выглядеть
вызвать: вызвать
вызов: Вызов вызове вызовы вызовов вызова
вызывать: Вызывая вызываем вызывать
вынудить: вынуждены
выполнение: выполнением Выполнение выполнения
выполнять: выполнять выполняем
выполняться: выполняется
выпуск: выпуска
гарантированно: гарантированно
гарантировать: гарантируете гарантирует гарантируют гарантировать
гарантироваться: гарантируется
гарантия: гарантиям гарантий гарантии
где: где
глава: главах главе главы
глобально: глобально
глобальный: глобальных глобальной Глобальные
говорить: говорим говорили
гонка: гонки гонке гонок
граница: границах
давать: Давайте даёт даём
далее: Далее
данные: Данных данные данным
данный: данном данный
дать: дали
два: два
дважды: дважды
действие: действия действий действие
действительный: действительной действительны действительную действительными действителен действительным
действовать: действующих
делать: делаю делать делает Делайте делаем
дело: дела деле
демонстрировать: демонстрирует
дерево: дереве
длина: длину длиной длина длины
добавить: добавив добавить
добавление: добавления
добавлять: добавлять добавляем добавляя
довольно: довольно
документация: документацию
должный: должен должны должна
дополнительный: дополнительные дополнительное
допускать: допускающих
допустимый: допустимых допустимые допустимый
достаточный: достаточной
достоверность: достоверности
доступ: Доступ доступа доступом
доступный: доступной доступны доступным доступен
другой: другой Другая другие другим других другом другому другого другое другими
дублировать: дублировать
единственный: Единственное
ее: её
еще: ещё
жизнь: жизни
завершение: завершение
завершиться: завершиться
загадка: загадки
задача: задачи
заимствование: заимствование заимствования заимствований
заимствовать: заимствуем
заключаться: заключается
заключить: заключить
закодировать: закодированного
замыкание: замыкания
запаниковать: запаникует
записываться: записываться
запись: Запись
запрещать: запрещающие
заработать: заработала
затем: затем
захватывать: захватывают
захотеть: захотеть
зачем: зачем
звездочка: Звёздочка
знать: знаю знать знаем
значение: значений значениями значения значение
значит: значит
игнорировать: игнорировать
игра: игры
изменение: изменение изменений
изменяемость: изменяемость
изменяемый: изменяемой изменяемыми изменяемые изменяемых изменяемую изменяемого изменяемым
изменять: изменяемый изменять
изолировать: изолировать
иметь: имейте иметь имеет имеющего имеющей имеют
имя: имени именем Имя имена имён
инвариант: инвариант
инварианты: инварианты
индекс: индексу индекс индекса
иногда: Иногда
инструмент: инструменты
интеграция: интеграцию
интерфейс: интерфейс интерфейса
информация: информацией информации
искажать: искажать искажает
искажение: Искажение
исполнение: исполнение
использование: Использование использования использованием использовании
использовать: использующей использовать используете используем используя использует используемые используемым использована
использоваться: использоваться используются
используйте: используйте
исследование: исследовании
источник: источника
исходный: исходного
итератор: итераторы итераторов
каждый: каждой каждого каждом
какой: какой
качество: качестве
ключ: ключей
ключевой: ключевого Ключевые ключевое ключевым
книга: книги книге
когда: Когда
код: код кода коде кодом коду
количество: количество
коллекция: коллекции
команда: команд
командный: командной
комментарий: Комментарии
компилироваться: компилируется
компилятор: компилятор компиляторе
компилятору: компилятору
компиляция: компиляции
компьютер: компьютера
конец: конца
конкретный: конкретные конкретном
консервативный: консервативен
константа: константы константами
конструкция: конструкции Конструкция
контекст: контексте
контракт: контракт
конфиденциальность: конфиденциальностью
концепция: концепции
корректный: корректным корректными корректный
кортеж: кортеже
который: которые котором который которой которых которого которая которым которое которыми
крейт: крейтов крейты крейта
куча: куче
лаконичный: Лаконичный
листинг: листинге Листинг
ложиться: ложится
любой: любые любом Любой
макрос: Макросы
максимально: максимально
маленький: маленькими
маркерный: маркерные
менее: менее
меньше: меньше
менять: меняет
место: места местах место месте
местоположение: местоположение
метод: метода методы метод методов
мир: Мир
многопоточность: многопоточности
многопоточный: многопоточного многопоточный многопоточное
множество: множество
модифицировать: модифицировать
модуль: модулей
модульность: модульности
можно: можно
момент: момент
мочь: могут может можете могли можем могла
мы: мы нас нам
мягкий: Мягкое
называть: называем называемых называют
называться: называется
наиболее: наиболее
наличие: наличие
написание: Написание написания
написать: написанным написанной
напомнить: Напомним
например: например
напротив: Напротив
напрямую: напрямую
нарушение: нарушением
нарушить: нарушены
настроить: настроить
настройка: Настройка
находиться: находиться находится
начало: начала
начать: начать начните
начинаться: начинающегося начинается
наш: нашего наших наши наш
небезопасный: Небезопасный небезопасное небезопасно небезопасные небезопасным небезопасном небезопасными небезопасной небезопасного небезопасных небезопасную небезопасная небезопасному небезопасен небезопасны
недействительный: Недействительные
недопустимый: недопустимых недопустимое
недостаточно: недостаточно
недоступный: недоступны
неизбежно: неизбежно
неизменяемый: неизменяемыми неизменяемый неизменяемые неизменяемой неизменяемую
некоторый: некоторую некоторые некоторого некоторый
нельзя: нельзя
необработанный: необработанных необработанный необработанные
необходимый: необходимой
неопределенный: неопределённому
непосредственно: непосредственно
неправильно: неправильно
непредсказуемый: непредсказуемой
несколько: несколько нескольких
нет: нет
неустранимый: Неустранимые
низкоуровневый: низкоуровневое низкоуровневого
никакой: никакой
ничто: ничего
новый: новый новых
нормально: нормально
нотация: нотации
нужный: нужно
нулевой: нулевого
обертывание: обёртывание
обеспечение: обеспечения обеспечение обеспечении
обеспечивать: обеспечивает обеспечивают
обещание: обещание
область: областью область области
облегчать: облегчает
обменять: обменять
обобщенные: Обобщённые
обобщенный: обобщённого
оборачивание: Оборачивание
оборудование: оборудованием
обработка: Обработка обработки
образ: образом
образец: образцом
обратить: Обратите
обращаться: обращаться обращаемся обращаются
обращение: Обращение
обсудить: обсудим
обсуждать: обсуждали обсуждать
обсуждаться: обсуждались
общий: Общие общим общую общему
объединение: объединения объединений объединениями объединениях
объект: объектов объекту
объектный: объектно
объявить: объявленные объявить объявленное
объявление: Объявление объявления
объявлять: объявляем
обычно: Обычно
обычный: обычными обычные обычная
один: одной одну Одним один одного одни одно одном
однако: Однако
одновременно: одновременно
однопоточный: однопоточного
одобрить: одобренным
ожидать: ожидать
означать: означает
окружение: окружение
он: он его
она: она неё
они: им их они них
опасность: опасностей
опасный: опасным
оператор: Операторы оператором оператор
операционный: операционной
операция: операции операций
определение: Определение определением
определенный: определённые
определить: определить определён
определять: определяет определяем
опровержимость: Опровержимость
оптимизировать: оптимизировать
организация: Организация
ориентировать: ориентированного ориентированных ориентированные
основный: основных основном
остальной: остальным
остаться: оставшееся
осторожный: осторожны
осуществить: осуществить
отвергнуть: отвергнет
ответственность: ответственность
отдельный: отдельном
отказавшись: Отказавшись
отключать: отключает
отключить: отключить
отличие: отличие
отслеживание: отслеживание
отсутствие: отсутствия
очистка: очистке очистка очистку
ошибка: ошибок ошибки ошибках ошибкам ошибкой ошибку
ошибочный: ошибочным
пакет: пакетов Пакеты
память: памяти памятью память
параллелизм: параллелизм
параллельный: параллельного
параметр: параметра
первый: первый
перевод: Переводы
передать: переданный передадим передан
передача: передачи
переключиться: переключиться
перекрываться: перекрываются
переменный: Переменные переменными переменной переменную переменных переменным
пересылка: Пересылка
перечисление: Перечисления
перечислять: перечисляем
печатать: печатает
писать: писать пишет
писаться: пишутся
поведение: поведения поведению
поверить: Поверь
поговорить: поговорим
подверженный: подвержены
поддерживать: поддерживает поддерживать
подробнее: Подробнее
подсчет: подсчётом
позволить: позволить
позволять: позволял позволяющего
поздний: позже
показать: показано
полагаться: полагаться
поле: полям поле
полезный: Полезные
полностью: полностью
получаете: получаете
получать: получает
получение: Получение получения
получить: получить получим
пользователь: пользователи
пользовательский: пользовательских
пометить: помеченных пометить
помечать: помечать помечая
помочь: помочь
помощь: помощью
понимание: Понимание
понимать: понимать понимает
понятие: понятие
понять: поняли понять
попробовать: попробуем
попытаться: попытаемся
попытка: Попытка попытке попытки
порядок: порядке
поскольку: Поскольку
последний: Последнее
последовательность: последовательности
посмотрев: Посмотрев
потенциально: потенциально
поток: потока поток потоков потоками потоке
потому: потому
потребоваться: потребоваться
похожий: похожи похож
поэтому: поэтому
правило: правила правил правилам
правильно: правильно
превращать: превращает
превращение: Превращение
предел: пределами
предисловие: Предисловие
предоставить: предоставить
предоставлять: предоставляет
предотвращать: предотвращает
предположение: предположение
предпочтительный: предпочтительно
предъявляться: предъявляются
предыдущий: предыдущих
прежний: прежнему
прибегнуть: прибегнуть
приведение: приведения
привести: привести приведёт
привет: Привет
приводить: приводит
приемлемый: приемлемое
прийти: пришло
прилинкован: прилинкована
приложение: Приложения приложений
применение: применений
применяться: применяются
пример: Пример примерах примера примере
примерно: примерно
принимать: принимает
принцип: принципе
природа: природе
присвоить: присвоить
причина: причина причин
проблема: проблемы проблем
проверить: проверена проверенные проверить
проверка: проверку проверки
проверять: проверяет проверяем
программа: программы программ программа
программирование: программирования Программирование
программист: программист программиста
продвинуть: Продвинутые
продемонстрировать: продемонстрировать
проект: проектами Проект проекта
проектирование: проектирования
производительность: производительности производительность
произвольный: произвольное произвольную произвольный произвольного произвольном
происходить: происходить
прописывать: прописывать
пропустить: пропустит
простота: простоты
профиль: профилей
процесс: процесса
прочитать: прочитали
прямой: прямое
публикация: Публикация
путь: Пути путей
пытаться: пытается
пять: пять пяти
работа: Работа работы
работать: работает
рабочий: Рабочие
равный: равно равен
раздел: раздела разделе
разделять: разделяемого разделяя разделяемую
различие: Различия различие
различный: различные различных
разместить: разместить
размещение: размещение
разный: разных разному
разработка: Разработка разработки
разыменование: разыменование разыменования
разыменовать: разыменован
разыменовывать: разыменовывать
располагать: располагать
рассмотреть: рассмотрим
расти: растущими
расширение: Расширение
расширить: Расширенные
расширять: Расширяемый
реализация: Реализация реализации реализацию
реализовать: реализованы реализованную реализуют реализовать реализуем реализует
редакция: Редакции
результирующий: результирующую
рекомендоваться: рекомендуется
рефакторинг: Рефакторинг
риск: риск
сам: само самом сам
сбой: сбою
сверхспособность: сверхспособности
свой: своё своей свой своём свои
связать: связанных связанными связанные
себя: себя себе
сегментация: сегментации
сервер: сервера сервер
си: Си
сигнатура: сигнатуры
сила: силами силы
символ: символы
синтаксис: Синтаксис
система: системой системы
системный: системное системного
ситуация: ситуации
сказать: сказать
скомпилировать: скомпилировать скомпилирована
скомпилироваться: скомпилируется
скорый: скорее
скрываться: скрывается
следовать: следует следовало
следующий: следующее следующем
слово: слова слово словом
сложнее: сложнее
случай: случаях случае случай
смещение: смещения
смотреть: смотря
смочь: сможет
сначала: сначала
соблюдать: соблюдать
соблюдение: соблюдение
собственный: собственной
соглашение: соглашению
содержать: содержащий содержит
создавать: создавать создавая создаёт создаём
создаваться: создаётся
создание: создание создания
создать: создать создали создадим созданный
сообщать: сообщаем
сообщение: сообщений
соответственно: соответственно
соответствовать: соответствовать соответствует
соответствующий: соответствующим
сопоставление: сопоставление
состояние: состоянием
состоять: состоит состоят
сохранить: сохранили
список: списков
способ: способ
способность: способностей
сравнение: Сравнение
сравнивать: сравнивая
среда: среды
срез: среза срезов срез срезы
срок: сроков
ссылаться: ссылаются
ссылка: Ссылки ссылок ссылками ссылку
ссылочные: Ссылочные
стандартный: стандартной
статический: статический статической статическую статическими Статические статических статическим
степень: степень
сторона: стороны
страх: страх
строка: строками строки
строковый: строкового
структура: структур структуры
супер: супер
существо: существу
существовать: существует
считать: считать считает
сыр: сыром
сырой: сырого сырых сырыми сырые сырой сырому
так: так
также: также
такой: такое таких такой Таким
там: Там
текст: текста
тело: теле Тела
тест: тестов тесты
тестирование: тестирование
техника: техники
тип: Типы Тип типов типа типам
типаж: типажи типажа типажей
тогда: тогда
только: Только
тонкий: Тонкое
тот: то том того ту той те
точно: точно
требование: требования
требовать: требуя требует
трейт: трейта трейтов трейт
трейты: трейты
трудный: трудным
убедиться: убедиться убедились
уверить: уверены
увидеть: увидите
узнать: узнать
указание: указания
указанный: указанному
указатель: указатели указателями указатель указателя указателей указателю указателе указателем
указать: указать
указывать: указывают указывает указываем указывать
улучшение: улучшения Улучшение
уместный: уместное
умный: Умные умными умный умных умён
упоминать: упоминали
управление: управления Управление
управлять: Управляющие
уровень: уровне
условие: условий
установка: Установка
устранимые: Устранимые
утверждение: утверждение
утечка: утечке утечку
учет: учётом
файл: файла файлов
фактически: фактически
фиксированный: фиксированный
финальный: Финальный
фрагмент: фрагмента фрагмент
функциональность: функциональности функциональность
функциональный: Функциональные
функция: Функции функций функцию функция функцией
характеристика: характеристики
ход: ходу
хотеть: хотим
хранение: Хранение
хранить: хранить
храниться: хранится хранятся
целый: целый
цель: целей цель
цикл: циклы
часто: часто
часть: Части часть частей
человек: Люди человека
четыре: четырёх
читабельный: читабельно
читать: читать читает
чтение: Чтение
что: чего Что чем
чтобы: Чтобы
чуть: чуть
шаблон: шаблона Шаблоны шаблон
эго: эго
экземпляр: экземпляров экземпляре
элемент: элемент элементов
это: этом это
этот: этой Этот Эти этим этого этих этому Эту Эта
эффект: эффект
являться: является являются являющийся
явно: явно
явный: явной
язык: Язык языка языков языком языке языку языки языкам языками
