аббревиатура: Аббревиатуры аббревиатура
автоматический: автоматических
агрегировать: агрегирует
актор: акторы
анализатор: анализатор
анонимный: анонимные
аргумент: аргументов аргумента
безбоязненный: Безбоязненный
безопасный: безопасной безопасный
библиотека: библиотеки библиотеке библиотека
билд: билдов
бинарный: бинарных
блокировать: блокирует
блокировка: блокировка
более: более
больший: большую
большой: больше
быть: будет будем быть будут есть было
важный: важных важную
валидация: Валидация
ваш: вашего ваших вашей
введение: Введение
вверх: вверх
ввод: вводом
веб: веб
вектор: векторами вектор
вернуть: вернёт
вернуться: вернитесь
весь: Все всё всех
вещь: вещь
взаимодействовать: взаимодействуют взаимодействовать
вид: виде
видимость: видимости
владелец: владельцем
владение: владения владение владении
владеть: владел владеть
вместо: вместо
внести: внесли
вниз: вниз
внимание: внимание
вновь: вновь
внутренний: внутренняя
вода: воды воду
возвращать: возвращает возвращаемых
возможность: возможности возможностей возможность
время: время времени
вступать: вступает
втекают: втекают
второй: вторым второму
вы: Вы
вывод: выводом вывод
выводимые: Выводимые
выводиться: выводиться
выглядеть: выглядеть
выдавать: выдаёт
вызвать: вызовем
вызывать: вызывает вызываем вызывая
выполнение: выполнением Выполнение выполнения выполнении
выполнять: выполняют выполняет
выполняться: выполняется
выпуск: выпуска
выразить: выражена
вычислительный: вычислительных
где: где
генерировать: генерировать генерирующих
глава: главе
давать: Давайте
данные: данных данные данными
дать: дать даст
два: двух два
движение: движение
действие: действия
действовать: действуют
делать: делать делаем делает
делиться: делитесь
дерево: дереве
деструктуризация: деструктуризацию
деструктурировать: деструктурирует
добавим: добавим
добавление: добавления
доказать: докажут
документация: документации
должный: должен должны
допускать: допускающих
доступный: доступно
друг: друг другом
другой: другому другая другой другую
еще: ещё
ждать: ждёт ждать
жизненно: жизненно
жизнь: жизни
завершение: завершение
зависимость: зависимости
загадка: загадки
задавать: задавая
задерживать: задерживает
заимствование: заимствование заимствования
закодировать: закодированного
закончиться: закончится
закрытый: закрытым
закрыть: закрыт
закрыться: закроется
замыкание: замыкания замыкание
запись: Запись
запуск: запуске запуск
запустить: запустите
заработать: заработает
затем: затем
захватывать: захватывают
здесь: Здесь
знать: знайте
значение: значений значениями значения значение значением
игра: игры
играть: играют
идея: Идея идеей
извлечение: извлечения извлечение
изменение: изменения
изменить: изменить
изменяемость: изменяемость
иметь: иметь имеет
инструкция: инструкцию инструкциях инструкции
инструмент: инструменты
интересный: интересным
информация: информацию
использование: Использование использования
использовать: использующей используя использовать используем использовали
использоваться: использоваться используются
источник: источников
исходный: Исходный
итератор: итераторы итераторов итератор
итерация: итерация
каждый: каждым каждую каждого каждой каждый
какой: какую какой
канал: каналы Канал канала каналу
клонировав: клонировав
клонирование: клонирования
ключ: ключей
ключевой: ключевого Ключевые
книга: книги
когда: когда
код: кода код
коллекция: коллекции
команда: команд
командный: командной
комментарий: Комментарии
компилироваться: компилируется
компиляция: компиляции
конец: конце концов
конструкция: конструкции Конструкция
конфиденциальность: конфиденциальностью
концепция: концепции
кончиться: кончится
коротко: Коротко
корректно: корректно
кортеж: кортеж кортежи кортежа
который: которые которого которой которым который которая которое которых
крейт: крейтов крейты крейта
куча: куче
лаконичный: Лаконичный
листинг: листинге Листинг листинга
любой: любыми любому
макрос: Макросы
мера: мере
место: места место
метод: метода методы методом метод
механизм: механизм
мир: Мир
многий: многих
многопоточность: многопоточности
многопоточный: многопоточного многопоточный многопоточных многопоточном
множество: множество
модуль: модулей
модульность: модульности
момент: момента
мочь: могут может можете можем мог
мы: Мы нас нам
мягкий: Мягкое
набирать: набирает
называть: называемый называем
наличие: наличие
напечатать: напечатанное напечатать
написание: Написание
написать: написать
направить: направленное
например: например
настройка: Настройка
начать: начать начнём
наш: нашего Наша
небезопасный: Небезопасный
недетерминированный: недетерминированным
некоторый: некоторые
некуда: некуда
необходимый: необходимо
несколько: несколько нескольких
несуществующий: несуществующих
нет: нет
неустранимый: Неустранимые
неясно: неясно
никакой: никаких никакой
ничто: ничего
новый: новый нового
обеспечение: обеспечения
область: областью область области
обобщенные: Обобщённые
обрабатывать: обрабатывает
обработать: обработали
обработка: Обработка обработки
образ: образом
образец: образцом
обратите: Обратите
обсудить: обсудим
общаться: общаются
общепринятый: общепринятый
общий: Общие общим
объединение: объединения
объект: объектов
объектный: объектно
обычный: обычными
один: одного Одна один одну одной одному
однако: Однако
одновременно: одновременно
однопоточный: однопоточного
ожидание: ожидание
ожидать: ожидаемым ожидает
ознакомиться: ознакомитесь
означать: означает
оказаться: окажется
оказываться: оказываются
окружение: окружение
он: его ним он нем
она: она
они: их они ними
оно: оно
оператор: Операторы
операция: операция
описать: описанное
определение: Определение
опровержимость: Опровержимость
опускать: опускаете
опять: Опять
организация: Организация
ориентировать: ориентированного ориентированных
основной: основной
основный: основным основном основного основному
останавливать: останавливает
отдельность: отдельности
отдельный: отдельный отдельных
отличный: Отлично
отправитель: отправителей
отправить: отправить отправили отправим отправлено
отправка: отправки отправка отправке
отправлять: отправлять отправляют отправляющих отправляющей отправлял отправляя отправляет
отправляться: отправляются
очередь: очередь
очистка: очистке очистка
ошибка: ошибок ошибки ошибках ошибку ошибкам ошибка ошибке
пакет: пакетов Пакеты
память: памяти памятью
паника: паники
параллелизм: параллелизм
параллельный: параллельного
параметр: параметром параметра
пауза: паузу пауза паузой
первый: первый первому
перебирать: перебираем
перевод: Переводы
передавать: передавать передавая передающая передающую
передатчик: передатчика Передатчик передатчиком передатчике
передать: переданы передать передадим
передача: передачи Передача
переменный: Переменные переменными переменным
переместить: переместим
перемещаться: перемещается
перемещение: Перемещение перемещения
пересылка: Пересылка
перечисление: Перечисления
печатать: печатаем
писать: писать
плохой: плохой
плыть: плыть плывёт
поведение: поведения поведение
подробнее: Подробнее
подсчет: подсчётом
подход: подхода
пока: пока
показать: показано показать
поле: полях
полезный: Полезные полезно
полный: полной
половина: половин половина
получатель: получатель получателем получателю
получать: получать получаем
получение: Получение получения
получить: полученные получим получено полученного
пользовательский: пользовательских
поместить: поместите поместили
помогать: помогают
помощь: помощью
понимание: Понимание
понять: понять
попробуйте: Попробуйте
популярность: популярность
попытаться: попытаемся попытались
попытка: Попытка
пора: пор
породить: порождённый порождённом порождённого порождённому
порядок: порядке
поскольку: Поскольку
последовательность: последовательности
посмотреть: посмотрели
поставщик: поставщиков
поступать: поступающих
поступить: поступит поступило
потенциально: Потенциально
поток: потоками потока поток потоков потоки потоку потоком потоке потоках
потому: потому
потребитель: потребитель
потреблять: потребляет
похожий: похоже
почему: почему
поэкспериментировать: поэкспериментируете
поэтому: поэтому
правило: Правила
правильный: правильной
превращение: Превращение
предисловие: Предисловие
предотвращение: Предотвращение предотвращения
представить: представить
представьте: Представьте
прежде: прежде
преимущество: преимуществом
привести: привести привела
привет: Привет
приемник: приёмника приёмник
приложение: Приложения приложении
пример: Пример примере
примерно: примерно
принимать: принимающую принимающая принимает
приостанавливать: приостанавливает
присваивание: присваивание
проблема: проблем
проверка: проверка
проверять: проверяет
провести: проведём
программа: программы программу программах
программирование: программирования Программирование программировании
продвинуть: Продвинутые
проект: проектами Проект проекта
проектирование: проектирования
произвести: произведена
производитель: производителей производителя
производительность: производительности
проиллюстрировать: проиллюстрировать
происходить: происходит
промежуток: промежутке
простой: простые
простота: простоты
противоречивый: противоречивых
профиль: профилей
публикация: Публикация
путь: Пути путей путём
пытаться: пытаемся
работа: Работа работы работу
работать: работает работают
рабочий: Рабочие
равный: равным
раз: раз
разделять: разделяемого разделяемой
различный: различные
размышление: размышлений
разный: разных разные
разобрать: разобрать
разработка: Разработка разработки
разрешить: разрешён Разрешить
ранее: Ранее
распечатывать: распечатывать
рассмотреть: рассмотрим
расти: растущими
расчет: расчёта
расширение: Расширение
расширить: Расширенные расширим
расширять: Расширяемый
реализация: Реализация
реализовать: реализованы реализует
реальный: реальном
редакция: Редакции
резиновый: резиновую резиновых резиновые резиновой
результат: результаты результат результатам результате
река: реку реке реки
рефакторинг: Рефакторинг
роль: роль
ручей: ручей ручьёв
свой: своё свою своим
связать: связанных связанными
связываться: связывался
сделать: сделать
сейчас: Сейчас
секунда: секунду секунде
сервер: сервера сервер
символ: символы
синтаксис: Синтаксис
система: система системы
ситуация: ситуацию
сказать: сказать
скомпилировать: скомпилировать
следующий: следующий
слово: слова
слоган: слогане
сложный: сложным
случай: случае
случайный: случайного
смочь: сможете сможем
сначала: Сначала
снова: снова
совместно: совместно
содержать: содержащее
создав: создав
создавать: создаём
создаваться: создаётся
создание: создание создания
создать: создадим созданный
сокращение: сокращением
сообщение: сообщений сообщение сообщения сообщением
соответственно: соответственно
соответствовать: соответствовать
соответствующий: соответствующие
сопоставление: сопоставление
состояние: состоянием
состоять: состоит
список: списков
способ: способ способом
сравнение: Сравнение
сразу: сразу
среда: среды
срез: среза
срок: сроков
ссылка: Ссылки ссылок ссылками
ссылочные: Ссылочные
стандартный: стандартной стандартная
становиться: становится
стоить: стоит
сторона: сторону стороной сторона
стратегия: стратегии
строка: строками строки строку строк строкой
структура: структур структуры
считаться: считается
так: так
такой: такое таким
текст: текста
текущий: текущий
теперь: теперь
тест: тестов тесты
тестирование: тестирование
течение: течению течение
тип: Типы Тип типов
типаж: типажи
тот: тех того то тому
традиционно: традиционно
трейт: трейта трейтов трейт
трейты: трейты
увидеть: увидим увидеть
удалить: удалён удалить
удобный: удобным
уже: уже
указание: указания
указатель: указатели указателями указатель
улучшение: улучшения Улучшение
уместный: уместна
умный: Умные умными умный
уничтожить: уничтожена
упоминать: упоминали
управление: управления Управление
управлять: Управляющие
установка: Установка
устранимые: Устранимые
утечка: утечке
утка: утку
уточка: уточку уточек уточки
файл: файла файлов Файл
финальный: Финальный
функциональность: функциональности
функциональный: Функциональные
функция: Функции функцию Функция
характеристика: характеристики
хороший: лучше
хотеть: хотите хотим
хранение: Хранение
цикл: циклы цикл
часть: часть частей
чат: чата чате
чтение: Чтение
что: чего Что
шаблон: шаблона Шаблоны шаблон шаблоном шаблонов
экземпляр: экземпляров
эксперимент: эксперимент
элемент: элемент элементов элементом
это: это
этот: этом этого эту этим этот эти
являться: является
явно: явно
язык: Язык языка языков
