конструкция: Конструкция конструкции
поток: потока поток потоков потоками потоком
управление: управления Управление
язык: Язык языка языков языках
программирование: программирования Программирование
предисловие: Предисловие
введение: Введение
что: чего Что
начать: начать
установка: Установка
привет: Привет
мир: Мир
игра: игры игру
загадка: загадки
общий: Общие общим
концепция: концепции
переменный: Переменные переменными переменных переменную переменная переменной
изменяемость: изменяемость
тип: Типы Тип типов типа типу
данные: Данных данные данным
функция: Функции функцию функция функциями
комментарий: Комментарии
управлять: Управляющие Управляющая
понимание: Понимание
владение: владения владение
такой: такое Таким такой Такую такая
ссылка: Ссылки ссылок ссылками
заимствование: заимствование
срез: среза
использование: Использование использовании
структура: структур структуры
объединение: объединения
связать: связанных связанными связанный
определение: Определение
создание: создание
экземпляр: экземпляров
пример: Пример примера примере
программа: программы программа программе
использовать: использующей используем используя использующее используемое использовать использующая использует
синтаксис: Синтаксис синтаксису
метод: метода метод
перечисление: Перечисления Перечисление перечислением перечислений
сопоставление: сопоставление сопоставления
образец: образцом образец Образцы образцу
лаконичный: Лаконичный
расти: растущими
проект: проектами Проект проекта
помощь: помощью помощи
пакет: пакетов Пакеты
крейт: крейтов крейты крейта
модуль: модулей
область: областью область области
действие: действия действие
конфиденциальность: конфиденциальностью
путь: Пути путей путём
элемент: элемент элементов
дерево: дереве
видимость: видимости
ключевой: ключевого Ключевые ключевое
слово: слова слово
коллекция: коллекции коллекцию
хранение: Хранение
список: списков списке
значение: значений значениями значения значение значением значению значениям значениях
вектор: векторами
закодировать: закодированного закодирован
текст: текста
строка: строками строки строке строк
ключ: ключей
обработка: Обработка обработки
ошибка: ошибок ошибки ошибках ошибку
неустранимый: Неустранимые
устранимые: Устранимые
трейты: трейты
характеристика: характеристики
время: время
жизнь: жизни
обобщенные: Обобщённые
разделять: разделяемого разделяет
поведение: поведения
валидация: Валидация
срок: сроков
написание: Написание
автоматический: автоматических
тест: тестов тесты
писать: писать
выполнение: выполнением Выполнение выполнения
организация: Организация
ввод: вводом
вывод: выводом
командный: командной
получение: Получение
аргумент: аргументов
чтение: Чтение
файл: файла файлов
рефакторинг: Рефакторинг
обеспечение: обеспечения
модульность: модульности
улучшение: улучшения Улучшение
разработка: Разработка разработки
функциональность: функциональности
библиотека: библиотеки
тестирование: тестирование
работа: Работа работы
среда: среды
запись: Запись
сообщение: сообщений
вместо: вместо
функциональный: Функциональные
возможность: возможности возможностей возможность
итератор: итераторы итераторов
замыкание: замыкания
анонимный: анонимные
который: которые который которое которая котором которому которой которую
захватывать: захватывают
свой: своё свою
окружение: окружение
последовательность: последовательности
наш: нашего наш нашей
сравнение: Сравнение сравнения
производительность: производительности
цикл: циклы
подробнее: Подробнее
настройка: Настройка
билд: билдов
профиль: профилей
выпуск: выпуска
публикация: Публикация
рабочий: Рабочие
бинарный: бинарных
расширение: Расширение
добавление: добавления
пользовательский: пользовательских
команда: команд
умный: Умные умными умный
указатель: указатели указателями указатель
указание: указания
куча: куче
обычный: обычными
трейт: трейта трейтов трейт
код: кода код коде
очистка: очистке очистка
подсчет: подсчётом
внутренний: внутренняя внутреннее
ссылочные: Ссылочные
мочь: могут может можем мог
привести: привести
утечка: утечке
память: памяти
безбоязненный: Безбоязненный
параллелизм: параллелизм
параллельный: параллельного
пересылка: Пересылка
передача: передачи
состояние: состоянием
расширять: Расширяемый
объектный: объектно
ориентировать: ориентированного ориентированных
объект: объектов
допускать: допускающих
разный: разных
реализация: Реализация
шаблон: шаблона Шаблоны шаблон шаблонами шаблонов шаблоне шаблоном шаблонам шаблонах
проектирование: проектирования
весь: Все всего всех вся всем
место: места мест
где: где
использоваться: использоваться используются
опровержимость: Опровержимость
соответствовать: соответствовать соответствующий соответствует
расширить: Расширенные
небезопасный: Небезопасный
продвинуть: Продвинутые
типаж: типажи
макрос: Макросы
финальный: Финальный
многопоточный: многопоточного многопоточный
веб: веб
сервер: сервера сервер
однопоточный: однопоточного
превращение: Превращение
мягкий: Мягкое
завершение: завершение
приложение: Приложения
оператор: Операторы оператор
символ: символы
выводимые: Выводимые
полезный: Полезные полезное полезно полезен
инструмент: инструменты
редакция: Редакции
перевод: Переводы
книга: книги
создаваться: создаётся
быть: есть будет быть будем было будете была был будут
чрезвычайно: чрезвычайно
мощный: мощный
механизм: механизм
именовать: именуемый
позволять: позволяет
сравнивать: сравнивать сравнивает сравниваем
различный: различными различные различным
затем: затем
выполнять: выполнять выполняемый
зависимость: зависимости
тот: того том то тех тем
какой: какой какая какие какого
совпасть: совпал совпали совпадёт
состоять: состоять состоят состоит
литеральный: литеральных литеральные
имя: имён именем
подстановочный: подстановочных
знак: знаков
многое: многого
другой: другого другая другие другое
глава: главе
рассматриваться: рассматриваются
вид: виды
они: они их них
делать: делают делали делает
сила: Сила
заключаться: заключается
выразительность: выразительности
компилятор: компилятор
проверять: проверяет
возможный: возможные
случай: случаи случае случая случай
обработать: обработаны обработать обработали
думать: Думайте
выражение: выражении выражение выражением выражения выражению
машина: машине
сортировка: сортировки сортировке
монета: монет монеты монета монетах монету
скользить: скользят
дорожка: дорожке
размер: размеру
отверстие: отверстиями отверстие
каждый: каждая каждый каждого каждым каждой
падать: падает
первый: первое первом первая первым первой первых
попасться: попавшееся
она: она её
поместиться: поместилась
образ: образом
проходить: проходят
подходящий: подходящем
попадать: попадает
блок: блок блока
говоря: Говоря
давать: давайте даёт
качество: качестве качество
это: этого Это этому
мы: мы нас нам
написать: напишем написать
получать: получать получает
вход: вход
неизвестный: неизвестную
соединить: Соединённых Соединённые
штат: Штатов Штаты штата
счетный: счётной
определять: определять
возвращать: возвращать возвращает
стоимость: стоимость
цент: центах центов
показать: показано
листинг: листинге Листинг
его: его
вариант: варианты вариантов варианта вариант
разобрать: разберём
сначала: Сначала
писаться: пишется
следовать: следует
данный: данном данного данной
являться: является являются
выглядеть: выглядит выглядеть
очень: очень
похоже: похоже
условный: условное
больший: большая
разница: разница
должный: должно должны должна
булев: булево
здесь: здесь
любой: любой любому
этот: этом этим этот этой эту эти
объявить: объявленное
далее: Далее
идти: идут идёт
ветка: ветки ветка веток ветку ветке веткой ветках
два: двух
часть: частей частям
некоторый: некоторый
иметь: имеет имела иметь
отделяться: отделяется
последующий: последующей последующие
запятая: запятой запятая
когда: Когда
выполняться: выполняется выполняться
оно: оно
получить: полученное получила получив получить получим
ответвление: ответвления ответвлений ответвлением ответвлении
порядок: порядку
совпадать: совпадает совпадающей совпадать
продолжаться: продолжается
следующий: следующей следующий следующим
так: так
автомат: автомате
столько: столько
сколько: сколько
нужный: нужно
четыре: четырёх
соответствующий: соответствующем
возвращаться: возвращается
обычно: Обычно
фигурный: фигурные
скобка: скобки
ветвь: ветви ветвь ветвью
небольшой: невелик
вы: вы
хотеть: хотите хотели хотим
выполнить: выполнить
несколько: несколько нескольких
один: одной одно один одна
необязательный: необязательна
например: Например
печатать: печатает
раз: раз
вызываться: вызывается
он: он него
последний: последнее последней последний
привязывающие: привязывающие
еще: ещё
привязываться: привязываться привязывается
можно: можно
извлекать: извлекать
изменить: изменим изменить
хранить: хранил
себя: себе
год: год
чеканить: чеканили
дизайн: дизайном дизайна
сторона: стороне
четверть: четверть
доллар: доллара долларов
дополнительный: дополнительную
особенность: особенность
добавить: добавить добавим
информация: информацию
изменение: изменения
включить: включить
сделать: сделано сделаем сделать
также: также
сохранять: сохраняет
представить: Представьте представлена
ваш: ваш
друг: друг друга
пытаться: пытается пытаться
собрать: собрать
четвертак: четвертаки четвертак четвертака
сортируя: Сортируя
сообщать: сообщать
название: название
относиться: относится
нет: нет
добавлять: добавляем добавляет
привязать: привязана привязать привязанных
смочь: сможем
вызов: вызов
пока: пока
достигнуть: достигнем
момент: момент
привязаться: привяжется
привязка: привязку
предыдущий: предыдущем предыдущих
раздел: разделе
уже: уже
независимо: независимо
остаться: останется
прежний: прежним
допустимый: Допустим
принимать: принимает
внутри: внутри
существующий: существующему
операция: операции
довольно: довольно
легкий: легко
более: более
подробно: подробно
рассмотреть: рассмотрим
вызывать: вызываем
тело: теле тел
поэтому: поэтому
продолжать: продолжаем
тогда: Тогда
содержаться: содержащемуся
ассоциированный: ассоциированный
создавать: создаём
новый: новое новую
теперь: Теперь
второй: второй
входить: входим входит
подразумевать: подразумевает
наличие: наличие
останавливаться: останавливается
находиться: находится
справа: справа
никакой: никакие никакое никакой
сравниваться: сравниваются
комбинирование: Комбинирование
многий: многих
ситуация: ситуациях
часто: часто
видеть: видеть
подобный: подобную
комбинация: комбинацию
основа: основе
показаться: показаться
немного: немного
сложный: сложным
привыкнуть: привыкнете
захотеть: захотите
неизменно: неизменно
любить: любимый
пользователь: пользователями
прием: приём
объемгод: объемлет
аспект: аспект
обсудить: обсудить
покрывать: покрывать
версия: версию
содержать: содержит
компилироваться: компилируется
вызвать: вызовет
дефект: дефект
счастие: счастью
знать: знает
уметь: умеет
ловить: ловить
попытаться: попытаемся
скомпилировать: скомпилировать
компиляция: компиляции
описать: описали
упустить: упустили
исчерпывающий: исчерпывающими исчерпывающим исчерпывающей
покрыть: покрыть
корректный: корректным
особенно: Особенно
забыть: забыть забыли
явный: явным
самый: самым
защищать: защищает
предположение: предположения
невозможный: невозможным
совершить: совершить
миллиард: миллиард
говориться: говорилось
ранее: ранее
универсальный: Универсальные универсальный универсальным универсального универсальном
заполнитель: заполнитель
специальный: специальные специальным
определенный: определённых
остальной: остальных остальная остальные
умолчание: умолчанию
реализовать: реализуем реализующий
выпадение: выпадении
игрок: игрок
двигаться: двигается
модный: модную
шляпа: шляпу
выпадать: выпадает
терять: теряет
перемещаться: перемещается
игровой: игровом
поле: поле
логика: логику логика
результат: результат
бросок: броска
кость: костей
жестко: жёстко
случайный: случайным
рамка: рамки
охватывать: охватывает
решить: решили
назвать: назвать
передавать: передавая
перечислить: перечислили
потому: потому
паттерн: паттерн
указать: указанным
конкретный: конкретном
удовлетворять: удовлетворяет
требование: требованию
соответствие: соответствие
обратите: Обратите
внимание: внимание
поместить: поместить
оцениваться: оцениваются
предупредить: предупредит
никогда: никогда
говорить: говорит говорим
собираться: собираемся
предупреждать: предупреждать
неиспользуемый: неиспользуемой
правило: правила
бросить: бросить
полнота: полноты
явно: явно
игнорировать: игнорируем
ничто: ничего
ход: ход
происходить: происходило
бросать: бросаете
выразить: выразить
единичный: единичное
пустой: пустой
кортеж: кортежа Кортежи
упоминать: упоминали
вместе: вместе
запускать: запускать
совпадение: совпадениях
поговорить: поговорим
перейти: перейдём
слишком: слишком
многословный: многословно
