автоматический: автоматических
анонимный: анонимные
аргумент: аргументов
безбоязненный: Безбоязненный
библиотека: библиотеки
билд: билдов
бинарный: бинарных
больший: больший
валидация: Валидация
введение: Введение
ввод: вводом
веб: веб
вектор: векторами
весь: Все всем
вид: виды
видимость: видимости
включать: включают
владение: владения владение
вместо: вместо
внутренний: внутренняя
возможность: возможности возможностей
время: время
вспомнить: Вспомните
вы: вам вы
вывод: выводом
выводимые: Выводимые
выполнение: выполнением Выполнение выполнения
выполниться: выполнится
выпуск: выпуска
выражение: выражениями выражения
где: где
глава: главы глава
давать: даёт
дальнейший: дальнейшем
данные: Данных данные
действие: действия
дерево: дереве
деструктурированные: Деструктурированные
добавление: добавления
допускать: допускающих
допустимый: допустимы допустимых
другой: другими
жизнь: жизни
завершение: завершение
загадка: загадки
заимствование: заимствование
закодировать: закодированного
замыкание: замыкания
запись: Запись
заполнитель: Заполнители
затем: Затем
захватывать: захватывают
значение: значений значениями значения значение значением значению
игра: игры
изменяемость: изменяемость
именовать: именованные
иметь: имеет
инструмент: инструменты
использование: Использование использования
использовать: использующей использовать используем
использоваться: использоваться использовались
итератор: итераторы итераторов
ключ: ключей
ключевой: ключевого Ключевые
книга: книги
код: кода код коде
коллекция: коллекции
команда: команд
командный: командной
комбинация: комбинации
комментарий: Комментарии
компонент: компоненты
конец: концу
конструкция: конструкции Конструкция конструкциями
контекст: контекстах
контроль: контроль
конфиденциальность: конфиденциальностью
концепция: концепции
кортеж: кортежи
который: которые которых
крейт: крейтов крейты крейта
куча: куче
лаконичный: Лаконичный
литерал: Литералы
макрос: Макросы
массив: массивы
машина: машины
место: места местах
метод: метода
мир: Мир
многий: многих
многопоточный: многопоточного многопоточный
модуль: модулей
модульность: модульности
момент: моментам
монета: монет
мочь: могут может можем можете
мы: мы
мягкий: Мягкое
написание: Написание
например: например
настройка: Настройка
начать: начать
наш: нашего наша нашем
небезопасный: Небезопасный
некоторый: некоторой Некоторые некоторым
неопровержимый: неопровержимыми
неустранимый: Неустранимые
обеспечение: обеспечения
область: областью область области
обобщенные: Обобщённые
обработка: Обработка обработки
образец: образцом
общий: Общие общим
объединение: объединения
объект: объектов
объектный: объектно
обычный: обычными
однопоточный: однопоточного
окружение: окружение
он: его
оператор: Операторы
описание: описание
описывать: описывают
определение: Определение
определенный: определённого
определить: определить
опровержимость: Опровержимость
опровержимый: опровержимыми
организация: Организация
ориентировать: ориентированного ориентированных
очистка: очистке очистка
ошибка: ошибок ошибки ошибках
пакет: пакетов Пакеты
память: памяти
параллелизм: параллелизм
параллельный: параллельного
перевод: Переводы
передача: передачи
переменный: Переменные переменными
пересылка: Пересылка
перечисление: Перечисления
писать: писать
поведение: поведения
подробнее: Подробнее
подсчет: подсчётом
полезный: Полезные
получение: Получение
пользовательский: пользовательских
помощь: помощью
понимание: Понимание
понятие: понятий
последовательность: последовательности
поток: потока поток потоков потоками потоком
правильный: правильную
превращение: Превращение
предисловие: Предисловие
привести: привести
привет: Привет
приложение: Приложения
пример: Пример примеры
программа: программы программа
программирование: программирования Программирование
продвинуть: Продвинутые
продолжение: продолжения
проект: проектами Проект проекта
проектирование: проектирования
производительность: производительности
произойти: произойдёт
простой: простых
профиль: профилей
публикация: Публикация
путь: Пути путей
работа: Работа работы
рабочий: Рабочие
разделять: разделяемого
различный: различные
разница: разнице
разный: разных
разработка: Разработка разработки
рассказать: расскажем
расти: растущими
расширение: Расширение
расширить: Расширенные
расширять: Расширяемый
реализация: Реализация
редакция: Редакции
рефакторинг: Рефакторинг
свой: своё
связать: связанных связанными связанный связанным
сервер: сервера сервер
символ: символы
синтаксис: Синтаксис синтаксиса
следующий: следующего
слово: слова
сложный: сложных
создаваться: создаётся
создание: создание
сообщение: сообщений
соответствовать: соответствовать соответствует
сопоставление: сопоставление сопоставления
сопоставлять: сопоставляет
сортировка: сортировки
состояние: состоянием
состоять: состоит
сочетание: сочетании
специальный: специальный Специальные
список: списков
справочник: справочник
сравнение: Сравнение
сравнивать: сравниваем
среда: среды
срез: среза
срок: сроков
ссылка: Ссылки ссылок ссылками
ссылочные: Ссылочные
строка: строками строки
структура: структур структуры структурой
так: так
такой: такое
текст: текста
тест: тестов тесты
тестирование: тестирование
тип: Типы Тип типов
типаж: типажи
тот: то
трейт: трейта трейтов трейт
трейты: трейты
увидеть: увидеть
узнать: узнаете
указание: указания
указатель: указатели указателями указатель
улучшение: улучшения Улучшение
умный: Умные умными умный
управление: управления Управление
управлять: Управляющие
установка: Установка
устранимые: Устранимые
утечка: утечке
файл: файла файлов
финальный: Финальный
форма: форму форме
фрагмент: фрагмента
функциональность: функциональности
функциональный: Функциональные
функция: Функции
характеристика: характеристики
хранение: Хранение
цикл: циклы
часть: части
чтение: Чтение
что: чего Что
шаблон: Шаблоны шаблона шаблон шаблонов шаблонами шаблоном
экземпляр: экземпляров
элемент: элемент элементов
это: это этого
этот: эти Эта
язык: Язык языка языков
ясный: ясного
