введение: Введение
путь: путей Пути путь путём
область: область областью области областях
видимость: видимости
помощь: помощью помощи
ключевой: ключевого Ключевые ключевое
слово: слова слово
язык: Язык языка языков языком
программирование: программирования Программирование
предисловие: Предисловие
что: чего Что
начать: начать
установка: Установка
привет: Привет
мир: Мир
игра: игры игру
загадка: загадки
общий: Общие общим общую Общей
концепция: концепции
переменный: Переменные переменными
изменяемость: изменяемость
тип: Типы Тип типов типа типом
данные: Данных данные
функция: Функции функциям функция функцию
комментарий: Комментарии
управлять: Управляющие
конструкция: конструкции Конструкция
понимание: Понимание
владение: владения владение
такой: такое таким таких
ссылка: Ссылки ссылок ссылками
заимствование: заимствование
срез: среза
использование: Использование использования использованием использовании
структура: структур структуры структура структурой структуру
объединение: объединения объединении Объединение
связать: связанных связанными
определение: Определение определения
создание: создание созданию
экземпляр: экземпляров
пример: Пример
программа: программы программе программах
использовать: использующей использовать используя использовали используем используемые
синтаксис: Синтаксис
метод: метода метод
перечисление: Перечисления перечислений перечисление
сопоставление: сопоставление
образец: образцом
поток: потока поток потоков потоками
управление: управления Управление
лаконичный: Лаконичный
расти: растущими
проект: проектами Проект проекта проекте
пакет: пакетов Пакеты пакет пакета пакету
крейт: крейтов крейты крейта крейтом крейте
модуль: модулей модуль модуля модуле модули
действие: действия
конфиденциальность: конфиденциальностью
элемент: элемент элементов элемента элементы
дерево: дереве
коллекция: коллекции
хранение: Хранение
список: списков списка
значение: значений значениями значения
вектор: векторами
закодировать: закодированного
текст: текста
строка: строками строки строку строке строкой строка
ключ: ключей
обработка: Обработка обработки
ошибка: ошибок ошибки ошибках Ошибка
неустранимый: Неустранимые
устранимые: Устранимые
трейты: трейты
характеристика: характеристики
время: время
жизнь: жизни
обобщенные: Обобщённые
разделять: разделяемого
поведение: поведения
валидация: Валидация
срок: сроков
написание: Написание
автоматический: автоматических автоматического
тест: тестов тесты
писать: писать
выполнение: выполнением Выполнение выполнения
организация: Организация
ввод: вводом
вывод: выводом
командный: командной
получение: Получение получения
аргумент: аргументов
чтение: Чтение
файл: файла файлов Файл файле
рефакторинг: Рефакторинг
обеспечение: обеспечения
модульность: модульности
улучшение: улучшения Улучшение
разработка: Разработка разработки
функциональность: функциональности
библиотека: библиотеки библиотека библиотекой библиотеку библиотеке
тестирование: тестирование тестировании
работа: Работа работы
среда: среды
запись: Запись
сообщение: сообщений
вместо: вместо
функциональный: Функциональные
возможность: возможности возможностей
итератор: итераторы итераторов
замыкание: замыкания
анонимный: анонимные
который: которые которой которого которое который которых которым
захватывать: захватывают
свой: своё своей
окружение: окружение
последовательность: последовательности
наш: нашего наш наша нашем нашему
сравнение: Сравнение
производительность: производительности
цикл: циклы
подробнее: Подробнее
настройка: Настройка
билд: билдов
профиль: профилей
выпуск: выпуска
публикация: Публикация
рабочий: Рабочие
бинарный: бинарных бинарного
расширение: Расширение
добавление: добавления Добавление добавлением
пользовательский: пользовательских
команда: команд
умный: Умные умными умный
указатель: указатели указателями указатель
указание: указания Указание
куча: куче
обычный: обычными
трейт: трейта трейтов трейт
код: кода код коде коду кодом
очистка: очистке очистка
подсчет: подсчётом
внутренний: внутренняя
ссылочные: Ссылочные
мочь: могут может можем могли
привести: привести
утечка: утечке
память: памяти
безбоязненный: Безбоязненный
параллелизм: параллелизм
параллельный: параллельного
пересылка: Пересылка
передача: передачи
состояние: состоянием
расширять: Расширяемый
объектный: объектно
ориентировать: ориентированного ориентированных
объект: объектов
допускать: допускающих
разный: разных
реализация: Реализация
шаблон: шаблона Шаблоны шаблон шаблоне
проектирование: проектирования
весь: Все всего
место: места
где: где
использоваться: использоваться используется использовался используются
опровержимость: Опровержимость
соответствовать: соответствовать
расширить: Расширенные
небезопасный: Небезопасный
продвинуть: Продвинутые
типаж: типажи
макрос: Макросы
финальный: Финальный
многопоточный: многопоточного многопоточный
веб: веб
сервер: сервера сервер
однопоточный: однопоточного
превращение: Превращение
мягкий: Мягкое
завершение: завершение
приложение: Приложения
оператор: Операторы Оператор оператора
символ: символы
выводимые: Выводимые
полезный: Полезные полезен полезно
инструмент: инструменты
редакция: Редакции
перевод: Переводы
книга: книги
создаваться: создаётся
подключение: Подключение подключения подключении
необходимость: Необходимость
записывать: записывать
вызов: вызова вызове
показаться: показаться
неудобный: неудобной
повторяться: повторяющейся
листинг: листинге Листинг листинги листинга
независимо: независимо
тот: того той том ту то те тех
выбирать: выбирали
мы: мы нам
абсолютный: абсолютный
относительный: относительный
каждый: каждый каждого
раз: раз
хотеть: хотели хотим
вызвать: вызвать вызвали
приходиться: приходилось
также: также
указывать: указывать указывает указывая
счастие: счастью
быть: есть был будет было будут Будьте были
способ: способ способом
упростить: упростить
этот: этот этой эту эти этих Эта
процесс: процесс
один: один одну одной одного одни одном одна
создать: создать
псевдоним: псевдоним
затем: затем
более: более
короткий: короткое
имя: имя именем именами имени имён имена
везде: везде
подключить: подключили подключить подключён
поэтому: поэтому
достаточный: достаточно
указать: указать указали
внутри: внутри
аналогично: аналогично
символический: символической
файловый: файловой
система: системе
корневой: корневой корневом корневого
становиться: становится
допустимый: допустимым
определить: определён определена определено определённые определены
подключенные: подключённые
проверяться: проверяются
доступность: доступность
любой: любые любым любого любом
другой: другие другой других другое другому другую другая другого
обратите: Обратите
внимание: внимание
создавать: создаёт
конкретный: конкретной
это: это этого этому этом
объявление: объявление
находиться: находится находятся
перемещаться: перемещается
новый: новый новых новое новой
дочерний: дочерний дочернем
отличаться: отличается отличаются
инструкция: инструкции Инструкция инструкцию инструкций
тело: тело
компилироваться: компилироваться
применяться: применяется
она: её
собственный: собственной
компилятор: компилятора
показывать: показывает
данный: данный данного
предупреждение: предупреждение
решить: решить
проблема: проблему проблемы
можно: можно
переместить: переместить
сослаться: сослаться
родительский: родительском родительского родительский родительских родительские
идиоматический: идиоматических идиоматическим идиоматический
вы: вы вами
задаться: задаться
вопрос: вопросом
почему: почему
полный: полного полный
прямо: прямо
результат: результата
неидиоматический: неидиоматическим
выполнять: выполняют
задача: задачу
являться: является
означать: означает
должный: должны должен
давать: даёт
понять: понять
локально: локально
сводить: сводя
минимум: минимуму
повторение: повторение
ясный: ясно
сторона: стороны
идиоматическ: идиоматически
правильный: правильным
стандартный: стандартной стандартная
включение: Включение включения
идиома: идиомой идиомы
нет: нет
веский: веской
причина: причины
соглашение: соглашение
появиться: появилось
сам: само
себя: собой себя
человек: Люди
привыкнуть: привыкли
читать: читать
образ: образом
исключение: Исключением
случай: случай
подключать: подключаем подключает
два: два двух две
одинаковый: одинаковыми одинаковым
позволять: позволяет
сделать: сделать сделали
они: них им
ссылаться: ссылаться
необходимый: необходимо необходимых
их: их
видеть: видите
различать: различать
иметь: имели имеют
смочь: смог
какой: какой какие
вид: виду
найти: нашёл
употребление: употребление
предоставление: Предоставление
решение: решение
локальный: локальное
написать: написать
переименование: переименования Переименование
он: он него
включить: включён включить
второй: второй
выбрать: выбрали
теперь: теперь
конфликтовать: конфликтовать
считаться: считаются
идиоматичный: идиоматичными
выбор: выбор
реэкспорт: Реэкспорт реэкспортом
доступный: доступное доступным доступными
приватный: приватным
позволить: позволить
вызывать: вызывает вызывать вызывающие вызывающих
оно: оно
объединить: объединить
называться: называется
потому: потому
делать: делаем
заменить: заменено
изменение: изменения
внешний: внешний внешних внешние внешним
повторно: повторно
экспортировать: экспортировало
ваш: вашего ваш вашей
программист: программисты программистов
думать: думают думать
предметный: предметной
например: Например
аналогия: аналогии
ресторан: рестораном ресторан ресторана
передний: передней
часть: части частях часть частей частью
дом: дома
задний: задней
клиент: клиенты
посещать: посещающие
вероятно: вероятно
термин: терминах
общедоступный: общедоступной общедоступного общедоступные
хорошо: хорошо
организовать: организована
работать: работающих
рассмотреть: рассмотрим
еще: ещё
его: его
влияние: влияние
документация: документацию
раздел: разделе
экспорт: Экспорт
удобный: удобного
глава: Главы Главе
запрограммировать: запрограммировали
угадывание: угадывания
число: числа
генерация: генерации Генерация
случайный: случайного
добавить: добавили добавить
качество: качестве
зависимость: зависимости
загрузить: загрузить
начинаться: начинающуюся начинающийся
название: названия
напомнить: Напомним
член: Члены
сообщество: сообщества
много: много
ресурс: ресурсе
включать: включает
шаг: шаги
отношение: отношению
поскольку: Поскольку
поставляться: поставляется
нужный: нужно
изменять: изменять
нее: неё
оттуда: оттуда
вложить: вложенных вложенные вложенного вложенный вложенном
уменьшение: уменьшения
длинный: длинных
несколько: несколько нескольких
определенный: определённых
отдельный: отдельной отдельных
занимать: занимать
вертикальный: вертикального
пространство: пространства
показать: показано показаны
следовать: следуют следует
двоеточие: двоеточия
фигурный: фигурные
скобка: скобки
продолжение: продолжения
префикс: префиксом
больший: больших
множество: множества
значительно: значительно
сократить: сократить
количество: количество
уровень: уровне
первый: первый
открытый: открытые
текущий: текущую
осторожный: осторожны
усложнить: усложнить
часто: часто
поговорить: поговорим
иногда: иногда
импорт: импорта
смотреть: смотрите
дополнительный: дополнительной
информация: информации
