реализация: Реализация реализации реализацию
шаблон: шаблона Шаблоны шаблон шаблону шаблонов
объектный: объектно
ориентированный: ориентированного ориентированным ориентированному ориентированные ориентированными
проектирование: проектирования
язык: Язык языка языков языкам
программирование: программирования Программирование
предисловие: Предисловие
введение: Введение
что: чего Что
начать: начать начнём
установка: Установка
привет: Привет
мир: Мир
игра: игры
загадка: загадки
общий: Общие общим общую
концепция: концепции
переменный: Переменные переменными
изменяемость: изменяемость
тип: Типы Тип типов типа типом
данные: Данных данные
функция: Функции функцией функция функций
комментарий: Комментарии
управлять: Управляющие управлять
конструкция: конструкции Конструкция
понимание: Понимание
владение: владения владение
такой: такое такой таким такую такие таких
ссылка: Ссылки ссылок ссылками ссылку ссылка
заимствование: заимствование
срез: среза
использование: Использование использования использованием
структура: структур структуры структура структуре структурах структуру
объединение: объединения
связать: связанных связанными связанной связано связанная
определение: Определение определения
создание: создание создания
экземпляр: экземпляров экземпляра экземпляр экземпляры
пример: Пример примера
программа: программы программе программа
использовать: использующей используем использующий использовать используемое используя использовали использующую использующие
синтаксис: Синтаксис
метод: метода методов метод методом методу методы методах
перечисление: Перечисления перечисление
сопоставление: сопоставление
образец: образцом
поток: потока поток потоков потоками
управление: управления Управление
лаконичный: Лаконичный
расти: растущими
проект: проектами Проект проекта
помощь: помощью помощь
пакет: пакетов Пакеты
крейт: крейтов крейты крейта крейте крейт
модуль: модулей
область: областью область области
действие: действия действий действие
конфиденциальность: конфиденциальностью
путь: Пути путей путь путём
элемент: элемент элементов элемента
дерево: дереве
видимость: видимости
ключевой: ключевого Ключевые
слово: слова
коллекция: коллекции
хранение: Хранение хранения
список: списков
значение: значений значениями значения значение значением значению
вектор: векторами
закодировать: закодированного закодировали
текст: текста текст
строка: строками строки строку строкой строке
ключ: ключей
обработка: Обработка обработки
ошибка: ошибок ошибки ошибках ошибку ошибке
неустранимый: Неустранимые
устранимые: Устранимые
трейты: трейты
характеристика: характеристики
время: время времени временем
жизнь: жизни
обобщенные: Обобщённые
разделять: разделяемого
поведение: поведения поведение поведении
валидация: Валидация
срок: сроков
написание: Написание
автоматический: автоматических
тест: тестов тесты тестом
как: Как
писать: писать
выполнение: выполнением Выполнение выполнения
организация: Организация организации
ввод: вводом
вывод: выводом
командный: командной
получение: Получение
аргумент: аргументов аргументом аргумента
чтение: Чтение
файл: файла файлов Файл
рефакторинг: Рефакторинг
обеспечение: обеспечения
модульность: модульности
улучшение: улучшения Улучшение
разработка: Разработка разработки
функциональность: функциональности функциональность
библиотека: библиотеки библиотеке
тестирование: тестирование
работа: Работа работы
среда: среды
запись: Запись записи записью записей
сообщение: сообщений сообщения сообщение
вместо: вместо
функциональный: Функциональные
возможность: возможности возможностей возможность
итератор: итераторы итераторов
замыкание: замыкания
анонимный: анонимные
который: которые которой которое который которым которых которая которого котором которому
захватывать: захватывают
свой: своё свой свои своего
окружение: окружение
последовательность: последовательности
наш: нашего нашей нашу наш наша
сравнение: Сравнение
производительность: производительности
цикл: циклы
подробнее: Подробнее
настройка: Настройка
билд: билдов
профиль: профилей
выпуск: выпуска
публикация: Публикация публикации публикацию публикаций
рабочий: Рабочие
бинарный: бинарных
расширение: Расширение
добавление: добавления добавление добавлении
пользовательский: пользовательских
команда: команд
умный: Умные умными умный
указатель: указатели указателями указатель
указание: указания
куча: куче
обычный: обычными
трейт: трейта трейтов трейт
код: кода код коде коду
очистка: очистке очистка
подсчет: подсчётом
внутренний: внутренняя внутреннее внутренней внутренний
ссылочные: Ссылочные
мочь: могут может мог могла можем могли можете
привести: привести приведёт
утечка: утечке
память: памяти
безбоязненный: Безбоязненный
параллелизм: параллелизм
параллельный: параллельного
пересылка: Пересылка
передача: передачи
состояние: состоянием Состояние состояний Состояния состояниями состоянии состояниях
расширять: Расширяемый
ориентировать: ориентированных ориентированный
объект: объектов объектом Объекты объект объекта объектах
допускать: допускающих
разный: разных
весь: Все всё всей всех
место: места место месте местах
где: где
использоваться: использоваться
опровержимость: Опровержимость
соответствовать: соответствовать соответствует
расширить: Расширенные расширить
небезопасный: Небезопасный
продвинуть: Продвинутые
типаж: типажи типаж типажа типаже
макрос: Макросы макроса
финальный: Финальный
многопоточный: многопоточного многопоточный
веб: веб
сервер: сервера сервер
однопоточный: однопоточного
превращение: Превращение
мягкий: Мягкое
завершение: завершение завершению
приложение: Приложения
а: А
оператор: Операторы
символ: символы
выводимые: Выводимые
полезный: Полезные
инструмент: инструменты
редакция: Редакции
перевод: Переводы
книга: книги
создаваться: создаётся
это: это этого этому
суть: Суть
заключаться: заключается
тот: том то того тому Тем
мы: мы Нам нас
определять: определяем определяет определять определяющий
набор: набор набором набора
иметь: иметь имеют имеет
представить: представлены
изменяться: изменяется
зависимость: зависимости
его: его
рассмотреть: рассмотрим рассмотреть рассмотрен
блог: блоге блога
быть: есть будет быть было будут будем были
поле: поле поля полем
черновик: черновик черновиком черновика черновики черновиков
обзор: обзор
опубликовать: опубликовано опубликованные опубликованы опубликована опубликовать опубликованной опубликованную опубликованный опубликован
конечно: конечно
наследование: наследование
каждый: Каждый Каждое каждом каждого каждой
отвечать: отвечает
сам: сам сама само сами
он: он ему него
должный: должен должно должны должна
перейти: перейти перешёл
другой: другое другие другом другой Другим
содержать: содержит содержащего содержать содержащее содержащей содержат
ничто: ничего
знать: знает знаем знают знал знаете
различие: различиях
когда: когда
один: одно одного одним один одной одну
преимущество: Преимуществом преимущества преимуществ
являться: является являться являются
изменение: изменении изменения изменениями изменение
требование: требований требованию
заказчик: заказчика
требоваться: требуется
изменять: изменять изменяли изменяет
нужный: нужно нужна нужны
обновить: обновить Обновлённый
изменить: изменить изменим
порядок: порядок
возможный: возможно возможными возможных
добавить: добавить добавили добавим добавленным добавив
больше: больше
начало: начала начале
реализовать: реализуем реализовать реализующие реализует реализующих реализовали реализуют
более: более
традиционный: традиционным
способ: способом способа способ
затем: затем
воспользоваться: воспользуемся
подход: подходом
естественный: естественным
давать: Давайте
шаг: шаг шагом
окончательный: Окончательный
функционал: функционал
выглядеть: выглядеть
так: так
пустой: пустой пустую пустым пустыми
готовый: готов
запрашиваться: запрашивается
проверка: проверка проверки проверку
происходить: происходит
возвращать: возвращают возвращать возвращал возвращает возвращающим возвращаемое возвращаем возвращающего возвращающий возвращаемые
содержимое: содержимое содержимого содержимому
печать: печать
поэтому: поэтому
пройти: прошедшие пройдёт
случайно: случайно
любой: Любые Любая
сделать: сделанные сделать сделаем
никакой: никакого никаких
эффект: эффекта
например: Например
попытаться: попытаемся попытаться
подтвердить: подтвердить
запросить: запросим запросить
остаться: остаться
неопубликованный: неопубликованным неопубликованной
листинг: листинге Листинг листинга
показать: показан показано показали покажем
этот: этот эту этой Эта этих эти этими этом
вид: виде видах
собираться: собираемся
имя: именем
пока: пока
компилироваться: компилируется
потому: потому
еще: ещё
создать: создан создать
демонстрировать: демонстрирующий
желаемый: желаемое
хотеть: хотим
получить: получить получили получим
пользователь: пользователь пользователями пользователи пользователям пользователей
новый: новый нового новой новое новую новых
разрешить: разрешить разрешены
сразу: сразу
она: её она ней неё
выход: выходе
утверждение: утверждение утверждения
демонстрационный: демонстрационных
цель: целей цель
бы: бы
отличный: отличным
модульный: модульным
далее: Далее
запрос: запрос запроса
завершить: завершена
вызов: вызове вызов вызова
возвратить: возвращён возвращённой
обратите: Обратите
внимание: внимание
единственный: единственный единственным
взаимодействовать: взаимодействуем взаимодействует
три: трёх
представлять: представляющих представлять
различный: различные различными различных
находиться: находиться находится находящейся находящаяся находящихся
ожидание: ожидание
переход: переходом переходы переходов
осуществляться: осуществляться
логика: логикой логику Логика
переключаться: переключаться
результат: результате результат результаты результатом
реакция: реакции
напрямую: напрямую
ошибиться: ошибиться
приступить: Приступим
публичный: публичная публичной публичный
хранить: хранящая
некоторый: некоторое некоторый некоторые некоторую некоторых
также: также
приватный: приватный приватным приватное
внутри: внутри
закрыть: закрытом
чуть: Чуть
поздний: позже
вы: вы вас вам
понять: поймёте понять
зачем: зачем
создавать: создаёт создаём
совместно: совместно
пост: поста пост
реализовывать: реализовывать
нет: нет
первый: первое первого первую
начинать: начинать начинаем
устанавливать: устанавливаем устанавливать устанавливают
указывать: указывает
гарантировать: гарантирует
всякий: всякий
раз: раз
появляться: появляется
поскольку: Поскольку
какой: каком какое какой каким
инициализировать: инициализируем
вызывать: вызывать вызываем вызывали вызывая
передать: передать
добавляться: добавляется
текстовый: текстовому текстовое
делать: делаем делая
публично: публично
доступный: доступным доступны доступной
означать: означает означало означают
смочь: сможем сможет
написать: написать
контролировать: контролировать
читаться: читаются
довольно: довольно
простой: прост простым
блок: блок
принимать: принимает принимать
изменяемый: изменяемую
менять: меняем меняет менять
передавать: передаём
сохранить: сохранённому сохранить
зависеть: зависит зависело
образ: образом
оно: оно
часть: частью часть части
вообще: вообще
поддерживать: поддерживать поддерживаем
убедиться: Убедимся
содержание: содержание
вызвать: вызвали вызовем вызван вызвать вызваны
контент: контент контента
фрагмент: фрагмент
черновой: черновом черновые чернового черновых
наиболее: наиболее
удовлетворять: удовлетворять
всегда: всегда
показывать: показывает
заглушка: заглушку заглушки
с: С
работать: работает работающей
задумать: задумано
вплоть: вплоть
добавлять: добавляем добавлять
текущий: текущего текущее
второй: второй
поглощать: поглощает поглощая
теперь: теперь
качество: качестве
параметр: параметра
указать: указан
действительный: действителен
обертка: обёрткой
становиться: становится
владелец: владельцем
старый: старое
недействительный: недействительным
преобразовать: преобразовано преобразовали преобразуют
поглотить: поглотить
стать: стать стало стал
приходить: приходит
забрать: забрать
оставить: оставить Оставим
позволять: позволяет
неинициализированный: неинициализированные
перемещать: перемещать перемещаем
заимствовать: заимствовать заимствованного
установить: установим установить
операция: операции
временно: временно
завладеть: завладеть
дать: даст дать
гарантия: гарантию гарантия
вернуть: вернуть вернёт
обернуть: обёрнутый
ожидать: ожидает
выполнять: выполняет
преобразование: преобразований преобразования
себя: себя собой
запрашивать: запрашиваем
уже: уже
продолжать: продолжать
оставаться: оставаться
видеть: видеть видели
одинаковый: одинаков
нести: несёт
ответственность: ответственность
одобрить: одобрить
аналогичный: аналогичен
одобрение: одобрении
упаковать: упакованный
случай: случаях случаев Случаи случай случае
перенести: перенести
задать: заданный
обновление: Обновление
делегирование: делегирования
состоять: состоит
выдавать: выдаёт
возвращаться: возвращается
если: Если
переместить: переместить
здесь: здесь
никогда: никогда
аварийный: аварийному
устроить: устроены
они: их них они
содержаться: содержится
говорить: говорили
раздел: разделе раздел раздела
информация: информации
компилятор: компилятора компилятор
глава: главы главе
встретиться: встретится
вступать: вступает
принудительный: принудительное
приведение: приведение
конечный: конечном конечные
итог: итоге Итоги
там: там
поместить: поместим
умолчание: умолчанию
прийтись: придётся
переопределять: переопределять
аннотация: аннотации
обсуждать: обсуждали
брать: берём
закончить: закончили
правило: правила правилами
процесс: процесса процесс
разбросать: разбросана
почему: Почему
интересный: интересно
вариант: вариантов варианте
безусловно: безусловно
решение: решений решении решением
попробовать: Попробуйте
сравнить: сравните
выбрать: выбрать
нравиться: нравится
недостаток: недостатков недостатком
проверяться: проверяется
потребоваться: потребуется потребуются
выражение: выражение выражения выражений
подобный: подобное
повторять: повторять
компромисс: Компромиссы компромиссов
способный: способен
инкапсуляция: инкапсуляции
достаточный: достаточно
взглянуть: взглянуть
участок: участок участки
узнать: узнать
отличие: отличия
захотеть: захотели
альтернативный: альтернативную
паттерн: паттерн
проверять: проверяли
несколько: нескольких
исследовать: исследовать
следствие: следствия
и: И
нагрузка: нагрузка
увеличиваться: увеличиваться
мера: мере
дополнительный: дополнительные
ответвление: ответвления
требовать: требуют
легкий: легко
увидеть: увидеть увидели
данный: данный
выполнить: выполнить выполнены
предложение: предложений
ниже: ниже
добавьте: Добавьте
обратно: обратно
потребуйте: Потребуйте
два: два
прежде: прежде
переводить: переводить
разрешите: Разрешите
тогда: тогда
подсказка: Подсказка
пусть: пусть
решать: решает
можно: можно
получаться: получаются
друг: друг
запланировать: запланировано
переходить: переходило переходим
меньше: меньше
продублировать: продублировали
устранить: устранить
дублирование: дублирование
однако: однако
нарушить: нарушило
безопасность: безопасность
конкретно: конкретно
безопасный: безопасными
включать: включает
схожий: схожие
оба: Оба Обе
делегировать: делегируют
много: много
следовать: следовали
устранение: устранения
повторение: повторения
смотри: смотри
реализуя: Реализуя
точно: точно
определить: определён определив
настолько: настолько
полно: полно
посмотреть: посмотрим
внести: внести
чтобы: чтобы
недопустимый: недопустимые
превратить: превратить
компиляция: компиляции
кодирование: Кодирование
переосмыслить: переосмыслить
полностью: полностью
инкапсулировать: инкапсулировать инкапсулированы
внешний: внешний
кодировать: кодировать
следовательно: Следовательно
система: система системы
предотвратить: предотвратит
попытка: попытки попытка
прежний: прежнему
сообщать: сообщающую
существовать: существует
отобразить: отобразить
скомпилироваться: скомпилируется
храниться: хранится
возврат: возврата
невозможный: невозможно невозможным невозможны
ранний: раньше
учесть: учтите
начинаться: начинаются
отображение: отображения отображение
обойти: обойти
ограничение: ограничения
обеспечить: обеспечить
соблюдение: соблюдение
утвердить: утверждён
отображать: отображать
превращать: превращает
забирать: забирают
потом: потом
преобразоваться: преобразуются
соответственно: соответственно
долгоживущий: долгоживущих
прочитать: прочитать
приводить: приводит
действительно: действительно
объявить: объявленный
смена: смены
небольшой: небольшие небольшое
затенять: затеняющих
присваивание: присваиваний
сохранять: сохранять
рассмотрение: рассмотрении
скомпилировать: скомпилировать
пытаться: пытался
подготовка: подготовки
переназначить: переназначить
совсем: совсем
менее: менее
больший: большую
выгода: выгоду выгоды
обнаружить: обнаружены
дойти: дойдут
задача: задачи
предложить: предложенные
версия: версии
сформировать: сформировать
мнение: мнение
дизайн: дизайне
нем: нём
модель: модели
очень: очень
хорошо: хорошо
знакомый: знакомы
шаблонами: шаблонами
переосмысление: переосмысление
проблема: проблем
предотвращение: предотвращение
хороший: лучшим
наличие: наличия
определенный: определённых
независимо: Независимо
думать: думаете
принадлежность: принадлежности
прочтение: прочтения
свойство: свойства
динамический: Динамическая
диспетчеризация: диспетчеризация
ваш: вашему вашего
гибкость: гибкость
обмен: обмен
ухудшение: ухудшение
улучшить: улучшить
сопровождаемость: сопровождаемость
в: В
особенность: особенности особенностью
опция: опцией
обеспечивать: обеспечивающей
высокий: высокую
бегло: бегло
рассказывать: рассказывали
протяжение: протяжении
вперед: Вперёд
