публикация: Публикация публикации публикацией публикацию
крейт: крейта крейтов крейты крейт крейтом крейте крейту
язык: Язык языка языков
программирование: программирования Программирование
предисловие: Предисловие
введение: Введение
что: чего Что чем
начать: начать начали
установка: Установка
привет: Привет
мир: Мир
игра: игры
загадка: загадки
общий: Общие общим общую
концепция: концепции концепций
переменный: Переменные переменными
изменяемость: изменяемость
тип: Типы Тип типов
данные: Данных данные
функция: Функции функций функция функцию
комментарий: Комментарии комментариев комментарием Комментарий комментария комментариях комментариями
управлять: Управляющие
конструкция: конструкции Конструкция
понимание: Понимание
владение: владения владение
такой: такое таким таких
ссылка: Ссылки ссылок ссылками
заимствование: заимствование
срез: среза
использование: Использование использования
структура: структур структуры Структура структурой структуру
объединение: объединения
связать: связанных связанными
определение: Определение определений определения
создание: создание создания
экземпляр: экземпляров
пример: Пример примеров примеры примерами примере
программа: программы Программа
использовать: использующей использовали использовать используя используют используемые используем использующий использует использующие использующая использующих
синтаксис: Синтаксис
метод: метода
перечисление: Перечисления
сопоставление: сопоставление
образец: образцом
поток: потока поток потоков потоками
управление: управления Управление
лаконичный: Лаконичный
расти: растущими
проект: проектами Проект проекта проекты проектов проектам
помощь: помощью
пакет: пакетов Пакеты пакета пакет
модуль: модулей модуля модуль модули модуле
область: областью область области
действие: действия
конфиденциальность: конфиденциальностью
путь: Пути путей
элемент: элемент элементов элементом элементу элементам элементы элементами
дерево: дереве
видимость: видимости
ключевой: ключевого Ключевые
слово: слова
коллекция: коллекции
хранение: Хранение
список: списков списком
значение: значений значениями значения значение
вектор: векторами
закодировать: закодированного
текст: текста текст
строка: строками строки
ключ: ключей ключ ключом ключа
обработка: Обработка обработки
ошибка: ошибок ошибки ошибках ошибку ошибка
неустранимый: Неустранимые
устранимые: Устранимые
трейты: трейты
характеристика: характеристики
время: время
жизнь: жизни
обобщенные: Обобщённые
разделять: разделяемого
поведение: поведения
валидация: Валидация
срок: сроков
написание: Написание написания
автоматический: автоматических
тест: тестов тесты теста
писать: писать
выполнение: выполнением Выполнение выполнения
организация: Организация организацию
ввод: вводом
вывод: выводом
командный: командной
получение: Получение
аргумент: аргументов
чтение: Чтение
файл: файла файлов Файл файле файлы
рефакторинг: Рефакторинг
обеспечение: обеспечения
модульность: модульности
улучшение: улучшения Улучшение
разработка: Разработка разработки разработке
функциональность: функциональности
библиотека: библиотеки библиотек библиотеку библиотеке библиотека
тестирование: тестирование
работа: Работа работы работу
среда: среды
запись: Запись записи
сообщение: сообщений
вместо: вместо
функциональный: Функциональные
возможность: возможности возможностей
итератор: итераторы итераторов
замыкание: замыкания
анонимный: анонимные
который: которые который которых которая которой котором которую которое
захватывать: захватывают
свой: своё своим свои своей свою свой своего
окружение: окружение
последовательность: последовательности
наш: нашего
сравнение: Сравнение
производительность: производительности
цикл: циклы
подробнее: Подробнее
настройка: Настройка настройки
билд: билдов
профиль: профилей
выпуск: выпуска
рабочий: Рабочие
бинарный: бинарных
расширение: Расширение
добавление: добавления Добавление добавлением
пользовательский: пользовательских
команда: команд команда команду
умный: Умные умными умный
указатель: указатели указателями указатель
указание: указания
куча: куче
обычный: обычными
трейт: трейта трейтов трейт
код: кода код кодом
очистка: очистке очистка
подсчет: подсчётом
внутренний: внутренняя внутреннюю внутренней
ссылочные: Ссылочные
мочь: могут может можете можем могли
привести: привести
утечка: утечке
память: памяти
безбоязненный: Безбоязненный
параллелизм: параллелизм
параллельный: параллельного
пересылка: Пересылка
передача: передачи
состояние: состоянием
расширять: Расширяемый
объектный: объектно
ориентировать: ориентированного ориентированных
объект: объектов
допускать: допускающих
разный: разных разными
реализация: Реализация
шаблон: шаблона Шаблоны шаблон
проектирование: проектирования
весь: Все всех весь всего всем
место: места месте
где: где
использоваться: использоваться используются используется
опровержимость: Опровержимость
соответствовать: соответствовать
расширить: Расширенные
небезопасный: Небезопасный небезопасна
продвинуть: Продвинутые
типаж: типажи
макрос: Макросы
финальный: Финальный
многопоточный: многопоточного многопоточный
веб: веб
сервер: сервера сервер
однопоточный: однопоточного
превращение: Превращение
мягкий: Мягкое
завершение: завершение
приложение: Приложения
оператор: Операторы операторов
символ: символы
выводимые: Выводимые
полезный: Полезные полезных полезным полезны полезной полезно
инструмент: инструменты инструмент
редакция: Редакции
перевод: Переводы
книга: книги
создаваться: создаётся
мы: Мы
качество: качестве
зависимость: зависимостей зависимости
вы: вы вам вас
также: также
поделиться: поделиться поделитесь поделились
другой: другими другим другие другой другое
человек: людьми Люди людей
опубликовать: опубликовав опубликованного опубликовать опубликовали
собственный: собственные
реестр: Реестр
адрес: адресу
распространять: распространяет
исходный: исходный исходным
ваш: ваших вашу вашей вашего вашим ваша вашем Вашему ваш
поэтому: поэтому
он: он его
основный: основном основным основных
размещать: размещает
открытый: открытым открытый
быть: есть быть будет будут был Будьте
облегчать: облегчают
поиск: поиск поиске поиска
далее: Далее
поговорить: поговорим
некоторый: некоторых некоторые
этот: этих этого Эта эти этот этим этой эту
затем: затем
объяснимый: объясним
документация: документации документацию документация документацией
аккуратный: Аккуратное
документирование: документирование документирования
помочь: поможет помочь
пользователь: пользователям пользователей Пользователи
знать: знать знали
когда: когда
они: их они им
стоить: стоит
потратить: потратить
глава: главе
обсуждать: обсуждали обсуждаем
комментировать: комментировать
два: две двух два
косой: косые
черта: черты
особый: особый
вид: вид виде
обычно: обычно
называться: называется
генерировать: генерирует
отображать: отображает
содержимое: содержимое
публичный: публичных публичного публичную публичным публичной
предназначить: предназначенных
программист: программистов
заинтересованный: заинтересованных
знание: знании
тот: того тому тех то том тем той
отличие: отличие
она: она её
реализовать: реализована
три: три
слеш: слеша
поддерживать: поддерживают поддерживать поддерживает
нотация: нотацию
форматирование: форматирования
размещайте: Размещайте
непосредственно: непосредственно
документировать: документируют документируем
листинг: листинге Листинг листинга
показать: показаны показано показан
имя: именем именами имена имя имени
здесь: Здесь
давать: даём даёт
описание: описание описания
делать: делает
начинать: начинаем
раздел: раздел разделы раздела разделах разделе
заголовок: заголовка заголовок заголовком
предоставлять: предоставляем предоставляете
демонстрировать: демонстрирует
сгенерировать: сгенерировать сгенерированную сгенерированный
запустив: запустив
запускать: запускает запускаем
поставлять: поставляемый
помещать: помещает
каталог: каталог каталоге
удобство: удобства удобство
создать: создадим создали создать
текущий: текущей текущем
открыть: откроем
результат: результат результатов результатах
браузер: браузере
перейдите: Перейдите
увидеть: увидите увидим увидеть
отображаться: отображается отображаться
рисунок: рисунке Рисунок
часто: Часто
автор: авторы Автору
сценарий: Сценарии
документированный: документированная
вызывать: вызывать вызывают вызывающих вызывает
паника: панику
вызывающий: Вызывающие
хотеть: хотят хотите хотим
паниковать: паниковали паникует
должный: должны должен должна
убедиться: убедиться
ситуация: ситуациях
возвращать: возвращает
произойти: произойти произойдёт
какой: какие какой каких какую
условие: условия условиях
возвратить: возвращены
так: так
написать: написать
различный: различных
способ: способами способы
безопасность: Безопасность
являться: является
вызов: вызова
объяснять: объясняющий
почему: почему
охватывать: охватывающий
инвариант: инварианты
ожидать: ожидает
сторона: сторон
подавлять: подавляющем
большинство: большинстве
случай: случаев случае случаях
нуждаться: нуждаются
это: это этому этом
хороший: хорошая лучше Хорошей
подсказка: подсказка
напоминать: напоминающая
аспект: аспектах
интересный: интересно
узнать: узнать
продемонстрировать: продемонстрировать
дополнительный: дополнительный
бонус: бонус
запуск: запуск
запустить: запустит запустим запустите
нет: Нет
ничто: ничего
плохой: хуже
работать: работают работающих работаете работать
потому: потому
измениться: изменился
момент: момента момент
подобный: подобный
теперь: Теперь
изменить: изменим изменить измените
снова: снова
обнаруживать: обнаруживают
синхронизировать: синхронизированы
друг: друг другом
комментирование: Комментирование
содержаться: содержащихся
стиль: Стиль
документ: документам
добавлять: добавляет добавляем добавлять
содержать: содержащему содержащего содержит содержащий
следующий: следующим следующей
корневой: корневого
соглашение: соглашению
целое: целом
например: Например
добавить: добавить добавьте
описывать: описывающую описывают описывающие описывает
назначение: назначение
начинаться: начинающиеся начинающейся
начало: начало
обратите: Обратите
внимание: внимание
последний: последней
никакой: никакого никакой
следовать: следует
данный: данном данный
корень: корнем
первый: первой Первая
страница: странице страница страницу
предоставить: Предоставленная
включая: включая
особенно: особенно
используйте: Используйте
объяснить: объяснить
цель: цель целей цели
контейнер: контейнера
понять: понять
экспорт: Экспорт
удобный: удобного удобной удобна удобную
общедоступный: общедоступного общедоступными
фактор: фактором
менее: менее
знакомый: знакомы
столкнуться: столкнуться
трудность: трудностями
часть: частей частью
иметь: имеет иметь
больший: большую
иерархия: иерархию иерархии
рассмотреть: рассмотрели
сделать: сделать сделало
ввести: ввести
однако: Однако
смысл: смысл
очень: очень
организовать: организовать организованными
несколько: несколькими несколько
уровень: уровнями уровне
тогда: тогда
желать: желающие
определить: определили определён определена
глубина: глубине
проблема: проблемой
раздражать: раздражать
необходимость: необходимость
вводить: вводить
новость: новостью
нужный: нужно
перестраивать: перестраивать
реэкспортировать: реэкспортировать реэкспортированные
отличный: отличную
реэкспорт: Реэкспорт реэкспорта реэкспорты
брать: берет
один: одном одно одного Одна
сказать: скажем
моделирование: моделирования
художественный: художественных
выглядеть: выглядеть
титульный: титульная
перечислить: перечислены
указать: указаны указать указали указанное укажите
главный: главной
равно: равно
нажать: нажать
зависеть: зависит зависящих зависеть зависящим
потребоваться: потребуются
подключать: подключают
определять: определяя
экспортировать: экспортированной
прийтись: пришлось придётся
выяснить: выяснить
находиться: находится
большой: больше
подходить: подходит
разработчик: разработчиков разработчики
кто: кто кем
информация: информации
пытаться: пытается
скорый: скорее
путаница: путаницу
искать: искать
указывать: указывать
выражение: выражениях
удалить: удалить
повторный: повторного
верхний: верхнем
перечислять: перечислять перечисляет
связывать: связывать
упрощая: упрощая
прежний: прежнему
видеть: видеть
более: более
иметься: имеется
много: много
вложить: вложенных
существенно: существенно
повысить: повысить
еще: Ещё
распространить: распространённое
зависимый: зависимого
искусство: искусство
наука: наука
повторять: повторять
найти: найти
подойти: подойдёт
гибкость: гибкость
структурировать: структурируете
внутри: внутри
отделять: отделяете
посмотрите: Посмотрите
установить: установленных
отличаться: отличается
учетный: учётной учётную
прежде: Прежде
смочь: сможете сможет смогут
любой: любые любой любым
необходимый: необходимо необходимы необходимые
получить: получить получите
токен: токен
зайти: зайдите
домашний: домашнюю
войдите: войдите
система: систему
настоящий: настоящее
требоваться: требуется
наличие: наличие
сайт: сайт
будущее: будущем
сразу: Сразу
вход: входа
выполнить: выполните выполним
сообщить: сообщит
сохранить: сохранит сохранили
локально: локально
секретный: секретным
делиться: делитесь
причина: причине
отозвать: отозвать
новый: новый новую новое новой новым
метаданные: метаданных метаданные
допустить: Допустим
понадобиться: понадобится
уникальный: уникальное уникального
пока: Пока
назвать: назвать
угодно: угодно
название: названия название названием
фиксироваться: фиксируются
присвоить: присвоено
никто: никто
поищите: поищите
уже: уже
подобрать: подобрать
отредактировать: отредактировать
поле: поле поля
публиковать: публикуемого
выбрать: выбрали
чтобы: чтобы
предупреждение: предупреждение
хватать: хватает
важный: важной
лицензия: лицензия лицензии лицензию лицензий
состоять: состоящее
предложение: предложений
оно: оно
появляться: появляться
вместе: вместе
идентификатор: идентификатора идентификаторы идентификатор идентификаторов
можно: можно
лицензировать: лицензировали
отсутствовать: отсутствует
поместить: поместить
включить: включите
руководство: Руководство
выбор: выбору
выходить: выходит
рамка: рамки
многий: Многие
сообщество: сообществе сообществом
лицензируют: лицензируют
двойной: двойную
практика: практика
разделить: разделённых
версия: версии версию Версия версий
готовый: готов готовы
образ: образом
легкий: легче
находить: находить
загружать: загружает
определенный: определённую
осторожный: осторожны
перманентный: перманентной
операция: операцией
никогда: никогда
перезаписать: перезаписана
подлежать: подлежит
удаление: удалению удаления
служить: служить
постоянный: постоянным
архив: архивом
сборка: сборки
продолжать: продолжали продолжать
предоставление: Предоставление
невозможный: невозможным
количество: количество
ограничить: ограничено
раз: раз
сейчас: Сейчас
выполниться: выполниться
успешно: успешно
поздравлять: Поздравляем
легко: легко
существовать: существующей существующим
внести: внесли
изменение: изменения изменений
выпустить: выпустить
повторить: повторите
воспользуйтесь: Воспользуйтесь
решить: решить
номер: номер
загрузить: загрузить загруженные
устранение: Устранение
устареть: устаревших
предыдущий: предыдущие
помешать: помешать
будущий: будущим
сломать: сломана
иной: иной
выламывание: выламывание
вычеркивание: Вычёркивание
позволять: позволяет
нее: неё
суть: сути
исключение: исключение
означать: означает
сломаться: сломаются
генерироваться: генерироваться
исключить: исключённую
вычеркнуть: вычеркнуть
директория: директории
ранее: ранее
добавив: Добавив
отменить: отменить
разрешить: разрешить
удалять: удаляет
случайно: случайно
пароль: пароли
немедленно: немедленно
сбросить: сбросить
