умный: Умные умными умный умных умного умным
указатель: указатели указателями указатель указателя указателей указателем
язык: Язык языка языков языках
программирование: программирования Программирование
предисловие: Предисловие
введение: Введение
что: чего Что
начать: начать
установка: Установка
привет: Привет
мир: Мир
игра: игры
загадка: загадки
общий: Общие общим общая
концепция: концепции концепция концепцией
переменный: Переменные переменными переменной
изменяемость: изменяемость
тип: Типы Тип типов типа
данные: Данных данные данными
функция: Функции
комментарий: Комментарии
управлять: Управляющие
конструкция: конструкции Конструкция
понимание: Понимание
владение: владения владение
такой: такое
ссылка: Ссылки ссылок ссылками ссылка ссылкой
заимствование: заимствование заимствования
срез: среза
использование: Использование
структура: структур структуры структурами
объединение: объединения
связать: связанных связанными
определение: Определение
создание: создание
экземпляр: экземпляров экземпляру экземпляр
пример: Пример примеров
программа: программы
использовать: использующей используемым
синтаксис: Синтаксис
метод: метода
перечисление: Перечисления
сопоставление: сопоставление
образец: образцом
поток: потока поток потоков потоками
управление: управления Управление
лаконичный: Лаконичный
расти: растущими
проект: проектами Проект проекта
помощь: помощью
пакет: пакетов Пакеты
крейт: крейтов крейты крейта
модуль: модулей
область: областью область области
действие: действия
конфиденциальность: конфиденциальностью
путь: Пути путей
элемент: элемент элементов
дерево: дереве
видимость: видимости
ключевой: ключевого Ключевые
слово: слова
коллекция: коллекции
хранение: Хранение
список: списков
значение: значений значениями значения значение
вектор: векторами
закодировать: закодированного
текст: текста
строка: строками строки
ключ: ключей
обработка: Обработка обработки
ошибка: ошибок ошибки ошибках
неустранимый: Неустранимые
устранимые: Устранимые
трейты: трейты
характеристика: характеристики
время: время времени
жизнь: жизни
обобщенные: Обобщённые
разделять: разделяемого
поведение: поведения
валидация: Валидация
срок: сроков
написание: Написание
автоматический: автоматических
тест: тестов тесты
писать: писать
выполнение: выполнением Выполнение выполнения
организация: Организация
ввод: вводом
вывод: выводом
командный: командной
получение: Получение
аргумент: аргументов
чтение: Чтение
файл: файла файлов
рефакторинг: Рефакторинг
обеспечение: обеспечения
модульность: модульности
улучшение: улучшения Улучшение
разработка: Разработка разработки
функциональность: функциональности функциональность
библиотека: библиотеки библиотеке библиотек
тестирование: тестирование
работа: Работа работы
среда: среды
запись: Запись
сообщение: сообщений
вместо: вместо
функциональный: Функциональные
возможность: возможности возможностей
итератор: итераторы итераторов
замыкание: замыкания
анонимный: анонимные
который: которые которая которой которое который которым
захватывать: захватывают
свой: своё свой свои своего
окружение: окружение
последовательность: последовательности
наш: нашего
сравнение: Сравнение
производительность: производительности
цикл: циклы
подробнее: Подробнее
настройка: Настройка
билд: билдов
профиль: профилей
выпуск: выпуска
публикация: Публикация
рабочий: Рабочие
бинарный: бинарных
расширение: Расширение
добавление: добавления
пользовательский: пользовательских
команда: команд
указание: указания
куча: куче
обычный: обычными обычной
трейт: трейта трейтов трейт
код: кода код
очистка: очистке очистка
подсчет: подсчётом подсчёт
внутренний: внутренняя внутренней внутреннего
ссылочные: Ссылочные
мочь: могут может можете
привести: привести
утечка: утечке
память: памяти
безбоязненный: Безбоязненный
параллелизм: параллелизм
параллельный: параллельного
пересылка: Пересылка
передача: передачи
состояние: состоянием
расширять: Расширяемый
объектный: объектно
ориентировать: ориентированного ориентированных
объект: объектов
допускать: допускающих допускает
разный: разных разные
реализация: Реализация
шаблон: шаблона Шаблоны шаблон
проектирование: проектирования
весь: Все
место: места
где: где
использоваться: использоваться
опровержимость: Опровержимость
соответствовать: соответствовать
расширить: Расширенные
небезопасный: Небезопасный
продвинуть: Продвинутые
типаж: типажи Типаж
макрос: Макросы
финальный: Финальный
многопоточный: многопоточного многопоточный
веб: веб
сервер: сервера сервер
однопоточный: однопоточного
превращение: Превращение
мягкий: Мягкое
завершение: завершение
приложение: Приложения
оператор: Операторы
символ: символы символом
выводимые: Выводимые
полезный: Полезные
инструмент: инструменты
редакция: Редакции
перевод: Переводы
книга: книги книге
создаваться: создаётся
содержать: содержит
адрес: адрес
участок: участка
этот: Этот этой этих эта
относиться: относится
указывать: указывает указывают
некоторый: некоторые некоторой
другой: другие другой других
наиболее: Наиболее
разновидность: разновидность
это: это
вы: вы
узнать: узнали
глава: главы главе глава
обозначаться: обозначаются
заимствовать: заимствуют
они: Они их них
иметь: имеют иметь имеет
какой: каких
специальный: специальных
ссылаться: ссылаться
никакой: никаких
накладный: накладных
расход: расходов
сторона: стороны
являться: являются является
действовать: действуют
также: также
дополнительный: дополнительные дополнительное Дополнительно
метаданные: метаданные метаданных
уникальный: уникальна
возникнуть: возникли
существовать: существуют существующие
быть: есть будет
определенный: определённые
стандартный: стандартной
обеспечивать: обеспечивают обеспечивает
выходить: выходящую
рамка: рамки
один: Одним
мы: мы
рассмотреть: рассмотрим
позволять: позволяет позволяют
несколько: несколько
владелец: владельцев
отслеживание: отслеживания
количество: количества
оставаться: остаётся
очищать: очищает
его: его
различие: различие
тот: то
часто: часто
владеть: владеют
ранее: Ранее
уже: уже
сталкиваться: сталкивались
называть: называли
так: так
например: например
оба: Оба
считаться: считаются
потому: потому
она: ею
манипулировать: манипулировать
гарантия: гарантии
хранить: хранит
размер: размер
вид: виде
гарантировать: гарантирует
содержимое: содержимое
всегда: всегда
кодировка: кодировке
обычно: обычно
реализоваться: реализуются
характерный: Характерной
черта: чертой
отличать: отличает
реализовать: реализованы
вести: вести
себя: себя
написать: написать
работать: работающий
он: ним
запускаться: запускаться
выйти: выйдет
обсудить: обсудим
типажа: типажа
продемонстрировать: продемонстрируем
почему: почему
важный: важны
учитывая: Учитывая
паттерн: паттерн паттерном
описывать: описывает
множество: Множество
охватить: охватим
распространить: распространённые
распределение: распределения
счетчик: счётчика
множественный: множественное
доступ: доступ
осуществляться: осуществляется
правило: правила
компиляция: компиляции
изменчивость: изменчивости
неизменяемый: неизменяемый
предоставлять: предоставляет
изменение: изменения
зацикленность: зацикленности
приводить: приводить
предотвратить: предотвратить
приступить: Приступим
