создаваться: создаётся создаются
язык: Язык языка языков
программирование: программирования Программирование
предисловие: Предисловие
введение: Введение
что: чего Что
начать: начать
установка: Установка установки
привет: Привет
мир: Мир
игра: игры
загадка: загадки
общий: Общие общим
концепция: концепции
переменный: Переменные переменными
изменяемость: изменяемость
тип: Типы Тип типов
данные: Данных данные
функция: Функции функция функций функциях
комментарий: Комментарии комментариев
управлять: Управляющие
конструкция: конструкции Конструкция
понимание: Понимание
владение: владения владение
такой: такое такой
ссылка: Ссылки ссылок ссылками
заимствование: заимствование
срез: среза
использование: Использование
структура: структур структуры структурой
объединение: объединения
связать: связанных связанными
определение: Определение определения
создание: создание
экземпляр: экземпляров
пример: Пример
программа: программы
использовать: использующей использована используют использовать используемой использует используете использующие
синтаксис: Синтаксис
метод: метода
перечисление: Перечисления
сопоставление: сопоставление
образец: образцом
поток: потока поток потоков потоками
управление: управления Управление
лаконичный: Лаконичный
расти: растущими
проект: проектами Проект проекта проекте проектов
помощь: помощью помощи
пакет: пакетов Пакеты
крейт: крейтов крейты крейта
модуль: модулей
область: областью область области
действие: действия
конфиденциальность: конфиденциальностью
путь: Пути путей
элемент: элемент элементов
дерево: дереве
видимость: видимости
ключевой: ключевого Ключевые ключевой
слово: слова
коллекция: коллекции
хранение: Хранение
список: списков список
значение: значений значениями значения
вектор: векторами
закодировать: закодированного
текст: текста
строка: строками строки
ключ: ключей
обработка: Обработка обработки
ошибка: ошибок ошибки ошибках
неустранимый: Неустранимые
устранимые: Устранимые
трейты: трейты
характеристика: характеристики
время: время временем времени
жизнь: жизни
обобщенные: Обобщённые
разделять: разделяемого
поведение: поведения
валидация: Валидация
срок: сроков
написание: Написание
автоматический: автоматических
тест: тестов тесты
писать: писать пишет
выполнение: выполнением Выполнение выполнения
организация: Организация
ввод: вводом
вывод: выводом вывода
командный: командной
получение: Получение
аргумент: аргументов
чтение: Чтение
файл: файла файлов
рефакторинг: Рефакторинг
обеспечение: обеспечения
модульность: модульности
улучшение: улучшения Улучшение
разработка: Разработка разработки разработке
функциональность: функциональности функциональность
библиотека: библиотеки
тестирование: тестирование
работа: Работа работы работу
среда: среды
запись: Запись
сообщение: сообщений
вместо: вместо
функциональный: Функциональные
возможность: возможности возможностей возможностями возможностях возможность
итератор: итераторы итераторов
замыкание: замыкания
анонимный: анонимные
который: которые которая которое который
захватывать: захватывают
свой: своё
окружение: окружение
последовательность: последовательности
наш: нашего Нашим наш нашей наши
сравнение: Сравнение
производительность: производительности
цикл: циклы
подробнее: Подробнее
настройка: Настройка
билд: билдов
профиль: профилей
выпуск: выпуска Выпуски выпуск выпуском выпуске
публикация: Публикация
рабочий: Рабочие
бинарный: бинарных
расширение: Расширение
добавление: добавления
пользовательский: пользовательских
команда: команд команда команду команды командой
умный: Умные умными умный
указатель: указатели указателями указатель
указание: указания
куча: куче
обычный: обычными
трейт: трейта трейтов трейт
код: кода код коде
очистка: очистке очистка
подсчет: подсчётом
внутренний: внутренняя
ссылочные: Ссылочные
мочь: могут может можем можете
привести: привести Приведём
утечка: утечке
память: памяти
безбоязненный: Безбоязненный
параллелизм: параллелизм
параллельный: параллельного
пересылка: Пересылка
передача: передачи
состояние: состоянием
расширять: Расширяемый
объектный: объектно
ориентировать: ориентированного ориентированных
объект: объектов
допускать: допускающих
разный: разных
реализация: Реализация
шаблон: шаблона Шаблоны шаблон
проектирование: проектирования
весь: Все вся
место: места
где: где
использоваться: использоваться используется
опровержимость: Опровержимость
соответствовать: соответствовать
расширить: Расширенные
небезопасный: Небезопасный
продвинуть: Продвинутые
типаж: типажи
макрос: Макросы
финальный: Финальный
многопоточный: многопоточного многопоточный
веб: веб
сервер: сервера сервер
однопоточный: однопоточного
превращение: Превращение
мягкий: Мягкое
завершение: завершение
приложение: Приложения
оператор: Операторы
символ: символы
выводимые: Выводимые
полезный: Полезные
инструмент: инструменты инструментов
редакция: Редакции
перевод: Переводы
книга: книги книга
дополнение: Дополнение
это: Это этом этого
рассказывать: рассказывает
влиять: влияет
вы: Вас Вы
разработчик: разработчика разработчиков разработчикам разработчики
стабильность: Стабильность стабильности
стагнация: стагнации
много: много
заботиться: заботиться заботитесь
ваш: Вашего вашей вашем
мы: Мы
хотеть: хотим хотят хотите
быть: был было быть есть была будет были будут
прочный: прочным
фундамент: фундаментом
опора: опорой
постоянно: постоянно
меняться: менялось меняться
невозможный: невозможно
тот: то Ту те того тем
экспериментировать: экспериментировать
различный: различными
обнаружить: обнаружить
важный: важные
проблема: проблемы
релиз: релиза релиз
они: их они
изменить: изменить
решение: решением решение
являться: является
руководить: руководящий
принцип: принцип принципу
никогда: никогда
должный: должны должно должна
бояться: бояться
переход: перехода
новый: новую новые новых новая новой новый
стабильный: стабильную Стабильный стабильной стабильных стабильные стабильная
версия: версию версий версией версии версия
каждый: Каждое Каждую Каждый Каждые каждой
обновление: обновление
безболезненный: безболезненным
также: также
добавлять: добавлять
меньше: меньше
дефект: дефектов дефекты
более: более
быстрый: быструю
скорость: скорость
компиляция: компиляции
канал: Каналы канала канал каналами
поездка: поездка
поезд: поезде поездов поезда поезд
работать: работает работать
расписание: расписания
совершаться: совершается
ветка: ветке ветку Ветка ветки
репозиторий: репозитория репозитории
следовать: следуют следует
модель: модели модель
последовательный: последовательного
продукт: продукта продуктами
другой: другими другие другое
программный: программными программного
три: три
ночной: Ночной ночная ночную ночные
бета: Бета
большинство: Большинство
кто: кто
попробовать: попробовать
экспериментальный: экспериментальные
процесс: процесс процессу процессе
давать: Давайте
предположить: предположим
его: Его
состояться: состоялся
декабрь: декабре
год: года
дать: даст
реалистичность: реалистичность
номер: номера
добавить: добавлена
коммит: коммиты
ночь: ночь
выпускаться: выпускается
день: день днём
этот: эти этому этой Этот Эта этих эту
автоматически: автоматически
мера: мере
идти: идёт идти
выглядеть: выглядят
так: так
шесть: шесть
неделя: недель
наступать: наступает
подготовка: подготовки
ответвляться: ответвляется
теперь: Теперь
иметь: имеем
два: два
многий: Многие
пользователь: пользователи пользователь пользователей
активно: активно
тестировать: тестируют
система: системе
обратный: обратной
совместимость: совместимости
найти: найдена найти
регрессия: регрессия
хорошо: Хорошо
протестировать: протестировать
попасть: попала попасть
исправление: Исправление
отправляться: отправляется
поэтому: поэтому
исправить: исправлена исправлен
затем: затем
направляться: направляется
происходить: происходит
ура: Ура
выпустить: выпущена выпустить
забыть: забыли
один: одну одного один
вещь: вещь
пройти: прошло пройти
следующий: следующей следующая следующего следующий следующую
ответвление: ответвления
снова: снова
называться: называется
потому: потому
покидать: покидает
станция: станцию
он: ему он
еще: ещё
нужный: нужно
час: часы
знать: знаете
дата: дату дате
поздний: позднее
хороший: Хорошим
аспект: аспектом
прибывать: прибывает
скоро: скоро
какой: какая
попадать: попадает
надо: надо
волноваться: волноваться
произойти: произойдёт
очень: очень
помогать: помогает
снизить: снизить
давление: давление
случай: случае
возможно: возможно
отполировать: отполирована
всегда: всегда
посмотреть: посмотреть
убедиться: убедиться
нее: неё
легкий: легко лёгким
перейти: перейти
ожидаться: ожидалось
сообщить: сообщить
поломка: Поломки
случаться: случаются
относительно: относительно
редко: редко
часть: частью часть
существовать: существуют
нестабильный: Нестабильные Нестабильных
техника: технику
называть: называемую
флаг: флаги флагом флаг флага
функционал: функционала
включить: включены
находиться: находится находящейся находитесь
активный: активной
она: она её
указать: указать
исходный: исходном
определенный: определённый
момент: момент
позволять: позволяет
практика: практике
стабилизация: стабилизацией
желать: желающими
нога: ногу
уверенный: уверенными
сломаться: сломается
содержать: содержит
информация: информацию
разрабатывать: разрабатываемые
продолжать: продолжают
несомненно: несомненно
отличаться: отличаться
зависимость: зависимости
написать: написана написать
когда: когда
сборка: сборки
интернет: интернете
роль: роль
делать: делает
изменение: изменение
глобальный: глобальном
локальный: локальном
уровень: уровне
умолчание: умолчанию
устанавливаться: устанавливается
выполнить: выполните
увидеть: увидеть
установить: установленные установить
ассоциированный: ассоциированные
компонент: компоненты
автор: авторов
компьютер: компьютером
видеть: видите
набор: набор
больший: большую
захотеть: захотите
конкретный: конкретном
передовой: передовых
каталог: каталоге
раз: раз
вызывать: вызываете
внутри: внутри
следить: следить
удобный: удобно
множество: множество множества
итак: Итак
узнавать: узнаете
запрос: запроса
улучшить: улучшить
предложение: предложение предложения
любой: Любой
рассматриваться: рассматриваются
обсуждаться: обсуждаются
состоять: состоит
тематический: тематических
подгруппа: подгрупп
сайт: сайте
полный: полный
включать: включает
дизайн: дизайн
компилятор: компилятора
инфраструктура: инфраструктура
документация: документация
многое: многое
соответствующий: Соответствующая
читать: читает
некоторый: некоторые некоторое
собственный: собственные
конечный: конечном
итог: итоге
приходить: приходит
согласие: согласию
принять: принять принята
отклонить: отклонить
реализовать: реализовать реализующий
задача: задача
открываться: открывается
человек: Человек
вполне: вполне
предложить: предложил
готовый: готова
ветвь: ветвь
обсуждать: обсуждали
раздел: разделе
через: Через
смочь: смогут
опробовать: опробовать
член: члены
обсудить: обсудят
решить: решат
приниматься: принимается
двигать: двигать
вперед: вперёд
ограничение: ограничение
убираться: убирается
считаться: считается
ехать: едет
