параллелизм: Параллелизм параллелизма
общий: общим Общие
состояние: состоянием состояние состоянии
язык: Язык языка языков языку языке
программирование: программирования Программирование
предисловие: Предисловие
введение: Введение
что: чего Что чем
начать: начать
установка: Установка
привет: Привет
мир: Мир
игра: игры
загадка: загадки
концепция: концепции
переменный: Переменные переменными переменную
изменяемость: изменяемость
тип: Типы Тип типов типах типа типом типу типам типами
данные: Данных данные данным данными
функция: Функции
комментарий: Комментарии
управлять: Управляющие управлять управляет
конструкция: конструкции Конструкция
понимание: Понимание понимания
владение: владения владение владению
такой: такое таком такой
ссылка: Ссылки ссылок ссылками ссылку ссылка
заимствование: заимствование
срез: среза
использование: Использование использования использовании использованием использованию
структура: структур структуры структура структуру
объединение: объединения
связать: связанных связанными
определение: Определение
создание: создание создания
экземпляр: экземпляров
пример: Пример примера примерах примеру примере
программа: программы программу
использовать: использующей используя использовать используемая используем использует использовали
синтаксис: Синтаксис
метод: метода методом метод
перечисление: Перечисления
сопоставление: сопоставление
образец: образцом
поток: потока поток потоков потоками потоку потоки потокам потоке потоком
управление: управления Управление управлении
лаконичный: Лаконичный
расти: растущими
проект: проектами Проект проекта
помощь: помощью
пакет: пакетов Пакеты
крейт: крейтов крейты крейта
модуль: модулей модуль
область: областью область области
действие: действия
конфиденциальность: конфиденциальностью
путь: Пути путей
элемент: элемент элементов
дерево: дереве
видимость: видимости
ключевой: ключевого Ключевые ключевое
слово: слова слово
коллекция: коллекции
хранение: Хранение хранения
список: списков
значение: значений значениями значения значение значению
вектор: векторами
закодировать: закодированного
текст: текста
строка: строками строки строках
ключ: ключей
обработка: Обработка обработки
ошибка: ошибок ошибки ошибках ошибке ошибку ошибкам
неустранимый: Неустранимые
устранимые: Устранимые
трейты: трейты
характеристика: характеристики
время: время времени
жизнь: жизни
обобщенные: Обобщённые
разделять: разделяемого разделяемое разделяемой
поведение: поведения
валидация: Валидация
срок: сроков
написание: Написание
автоматический: автоматических
тест: тестов тесты
как: Как
писать: писать
выполнение: выполнением Выполнение выполнения
организация: Организация
ввод: вводом
вывод: выводом
командный: командной
получение: Получение получения
аргумент: аргументов
чтение: Чтение
файл: файла файлов Файл
рефакторинг: Рефакторинг
обеспечение: обеспечения
модульность: модульности
улучшение: улучшения Улучшение
разработка: Разработка разработки
функциональность: функциональности
библиотека: библиотеки библиотек
тестирование: тестирование
работа: Работа работы работу
среда: среды
запись: Запись
сообщение: сообщений Сообщение
вместо: вместо
функциональный: Функциональные
возможность: возможности возможностей возможность
итератор: итераторы итераторов
замыкание: замыкания замыкание
анонимный: анонимные
который: которые которая который которое которой которую
захватывать: захватывают
свой: своё своего свою своей
окружение: окружение
последовательность: последовательности
наш: нашего наша наш нашему нашу
сравнение: Сравнение
производительность: производительности
цикл: циклы цикла
подробнее: Подробнее
настройка: Настройка
билд: билдов
профиль: профилей
выпуск: выпуска
публикация: Публикация
рабочий: Рабочие
бинарный: бинарных
расширение: Расширение
добавление: добавления
пользовательский: пользовательских пользовательскими
команда: команд
умный: Умные умными умный умным
указатель: указатели указателями указатель указателем
указание: указания
куча: куче
обычный: обычными
трейт: трейта трейтов трейт
код: кода код коде
очистка: очистке очистка
подсчет: подсчётом подсчёте подсчётам
внутренний: внутренняя внутреннему внутренние внутренней внутреннее внутреннюю
ссылочные: Ссылочные
мочь: могут может могли можете можем мог
привести: привести
утечка: утечке утечкам
память: памяти память
безбоязненный: Безбоязненный
параллельный: параллельного параллельный
пересылка: Пересылка
передача: передачи Передача передачей
расширять: Расширяемый
объектный: объектно
ориентировать: ориентированного ориентированных
объект: объектов объект
допускать: допускающих
разный: разных разными
реализация: Реализация реализацию
шаблон: шаблона Шаблоны шаблон
проектирование: проектирования
весь: Все всем всех
место: места
где: где
использоваться: использоваться
опровержимость: Опровержимость
соответствовать: соответствовать
расширить: Расширенные
небезопасный: Небезопасный небезопасен
продвинуть: Продвинутые
типаж: типажи типаж типажа типажей типажах
макрос: Макросы
финальный: Финальный
многопоточный: многопоточного многопоточный Многопоточное Многопоточная многопоточных многопоточном
веб: веб
сервер: сервера сервер
однопоточный: однопоточного однопоточном
превращение: Превращение
мягкий: Мягкое
завершение: завершение завершении
приложение: Приложения
а: А
оператор: Операторы
символ: символы
выводимые: Выводимые
полезный: Полезные полезную
инструмент: инструменты
редакция: Редакции
перевод: Переводы
книга: книги
создаваться: создаётся
прекрасный: прекрасный
способ: способ
единственный: единственный
другой: Другим другие других другой другими
быть: быть будет было будут будем
доступ: доступ
несколько: нескольких несколько несколькими нескольким
один: одним одной один одного одному одном одна одну
тот: тем того той то тех том
рассмотреть: Рассмотрим рассмотреть
еще: ещё
раз: раз
часть: часть частью части
слоган: слогана
документация: документации Документация
стоить: стоит
передавать: передавать передаёт передаём
информация: информацию
выглядеть: выглядело
общение: общение
разделяемую: разделяемую
почему: почему
энтузиаст: энтузиасты
предостерегать: предостерегают
он: его он ему ним него
какой: каком
смысл: смысле
канал: каналы каналу каналам
любой: любом любой
похожий: похожи
единоличный: единоличное
потому: потому
вы: вам вы вас
большой: больше
следовать: следует
отправить: отправленное
совместно: совместно
подобный: подобна
множественный: множественному множественное множественного
одновременно: одновременно
обращаться: обращаться
видеть: видели
глава: главе главу
сделать: сделали сделаем
возможный: возможным
добавить: добавить
сложность: сложность
нужный: нужно нужен
этот: этими Этот эти этим этой эту
владелец: владельцами владельцам
система: Система систему системе
правило: правила правилам
очень: очень
помогать: помогают помогает
их: их
правильный: правильном Правильное
давать: давайте давали
мьютекс: мьютексы мьютекс мьютексе мьютексами мьютексом мьютексов
наиболее: наиболее
распространить: распространённых
примитив: примитивов примитивы
предоставлять: предоставляют предоставляемые предоставляет
это: это этом
сокращение: сокращение
взаимный: взаимное взаимных
исключение: исключение
так: так
позволять: позволяет
получать: получать получает получаем
некоторый: некоторым
момент: момент
получить: получить получим получит получил
должный: должен должны
сначала: сначала
подать: подать
сигнал: сигнал
хотеть: хочет хотите
запрашивать: запрашивая запрашивает
блокировка: блокировку Блокировка блокировки блокировке блокировок
мьютекса: мьютекса
являться: являющаяся является являются
отслеживать: отслеживает
кто: кто
настоящий: настоящее
иметь: имеет имеют иметь
эксклюзивный: эксклюзивный
поэтому: Поэтому
описываться: описывается
защищать: защищающий защищает
хранить: хранит
репутация: репутацию
трудный: трудных
помнить: помнить
два: два двух
попытаться: попытаться
необходимый: необходимо
закончить: закончили закончит
разблокировать: разблокировать
представьте: представьте
групповой: групповое
обсуждение: обсуждение
конференция: конференции конференция
микрофон: микрофоном микрофон
прежде: Прежде
участник: участник участнику
дискуссия: дискуссии
смочь: сможет смогли
говорить: говорить говорит
спросить: спросить
дать: дать даст
когда: Когда
столько: столько
сколько: сколько
затем: затем
следующий: следующему следующих следующем следующее
попросить: попросит
выступить: выступить
забыть: забудет забыть
освободить: освободить освободит
никто: никто
идти: идёт
правильно: правильно
работать: работать работают работает
запланировать: запланировано
невероятно: невероятно
сложный: сложным сложных
многий: многие многих
человек: люди
энтузиазм: энтузиазмом
относиться: относятся
однако: Однако
разблокировка: разблокировку
неправильный: неправильным
образ: образом
листинг: листинге Листинг
изучение: Изучение
простота: простоты
контекст: контексте
мы: мы нам нас
создавать: создаём
сопутствующий: сопутствующей
вызов: вызов вызова вызове
блокировать: блокирует
текущий: текущего
выполнять: выполнять выполняете
никакой: никакие
пора: пор
пока: пока
наступить: наступит
очередь: очередь
потерпеть: потерпит
неудача: неудачу
удерживать: удерживающий
запаникует: запаникует
случай: случае случаях
предпочесть: предпочли
заставить: заставить
паниковать: паниковать
оказаться: окажемся
ситуация: ситуации ситуациях
воспринимать: воспринимать
возвратить: возвращённое
назвать: названное
данный: данном данный
изменяемый: изменяемую
содержаться: содержащиеся
внутри: внутри
гарантировать: гарантирует гарантировать
вызвать: вызвать
забывать: забывать
более: более
иной: иных
наверное: наверное
подозревать: подозреваете
точнее: Точнее
возвращать: возвращает
называть: называемый
обернуть: обёрнутый
обработать: обработали
реализовать: реализует реализованы реализовать
также: также
автоматически: автоматически
снимать: снимающего
выходить: выходит
происходить: происходит
конец: конце
результат: результате результат
нет: нет
риск: риска риском
снять: снять
оставить: оставить
заблокировать: заблокированном заблокировать
препятствовать: препятствуя
снятие: снятие снятия
можно: можно
напечатать: напечатать напечатает
увидеть: увидеть увидели
изменить: изменить
разделение: Разделение
множество: множеством
теперь: Теперь
попробовать: попробуем попробуйте
стартовать: стартуем
каждый: каждый каждого каждое
они: них
увеличивать: увеличивает увеличивающих
счетчик: счётчика счётчик счётчиком счётчику
изменяться: изменяется
обратите: Обратите
внимание: внимание
компилятора: компилятора
узнать: узнать
содержать: содержит
начальный: начальный
десять: Десять
защитить: защищённый защитить
делать: делали
перебирая: перебирая
диапазон: диапазон
число: чисел
одинаковый: одинаковое одинаковый
перемещать: перемещает
вызывать: вызывая вызываем
добавлять: добавляет
завершить: завершит завершим
выйти: выйдет
она: её
основный: основном
собирать: собираем
дескриптор: дескрипторы дескриптора
убедиться: убедиться
основной: основной
тоже: тоже
компилятор: Компилятор
намекнуть: намекнул
компилироваться: компилируется
выяснить: выясним
указывать: указывает
переместить: перемещёно
предыдущий: предыдущей
итерация: итерации
передать: передать
исправить: исправим
обсуждать: обсуждали
подсчитать: подсчитанных
самый: самое
здесь: здесь
посмотреть: посмотрим
произойти: произойдёт
завернуть: завернём
клонировать: клонируем клонированное
вернуться: вернёмся
сохранить: сохраним
попытка: Попытка
позволить: позволить позволило
владеть: владеть
компилировать: компилируем
учить: учит
ничего: Ничего
себя: себе
многословный: многословно
важный: важная
сосредоточиться: сосредоточиться
сообщать: сообщает
причина: причину Причина
поговорить: поговорим
раздел: разделе
предназначить: предназначены
к: К
сожаление: сожалению
совместный: совместного
добавляться: добавляется
вычитаться: вычитается
удаляться: удаляется
выход: выходе
многопоточность: многопоточности
изменение: изменения
прервать: прерваны
незначительный: незначительным
удаление: удалению
отработать: отработали
точно: точно
изменять: изменять изменяемый
безопасный: безопасно безопасен безопасны безопасный
атомарный: Атомарный атомарное атомарно атомарными
счастие: счастью
аналогичный: аналогичным
буква: Буква
означать: означает
подсчитывать: подсчитываемая
дополнительный: дополнительный дополнительную
вид: вид
подробно: подробно
описывать: описывать
смотрите: смотрите
стандартный: стандартной стандартные
знать: знать
примитивный: примитивные
вместе: вместе
умолчание: умолчанию
безопасность: безопасность
сопровождаться: сопровождается
снижение: снижением
платить: платить
тогда: тогда
действительно: действительно
операция: операции операций
ваш: ваш
быстрый: быстрее
обеспечивать: обеспечивать обеспечивают обеспечивает
гарантия: гарантии
исправлять: исправляем
заменять: заменяя
наконец: наконец
скомпилироваться: скомпилируется
запуститься: запустится
обертывание: обёртывания
посчитать: посчитали
показаться: показаться
впечатляющий: впечатляющим
увеличение: увеличение
стратегия: стратегию стратегии
разделить: разделить
вычисление: вычисления
независимый: независимые
обновлять: обновлял
конечный: конечный
простой: простые простым
числовой: числовые
существовать: существуют
решить: решили
сходство: Сходства
заметить: заметить
сам: сам
семейство: семейство
содержимое: содержимое содержимого
деталь: деталь
обратить: обратить
всевозможный: всевозможных
логический: логических
вспомните: Вспомните
сопрячь: сопряжено сопряжён
ссылочный: ссылочной
зацикленность: зацикленности
ссылаться: ссылаются
друг: друг друга
приводить: приводит
ресурс: ресурса
заставлять: заставляя
оба: оба
ждать: ждать
вечно: вечно
интересный: интересна
тема: тема
создать: создать
исследуйте: исследуйте
устранение: устранения
предлагать: предлагает
рассказать: рассказав
