выводимые: Выводимые
трейты: трейты
язык: Язык языка языков
программирование: программирования Программирование
предисловие: Предисловие
введение: Введение
что: чего Что
начать: начать
установка: Установка
привет: Привет
мир: Мир
игра: игры
загадка: загадки
общий: Общие общим
концепция: концепции
переменный: Переменные переменными переменных
изменяемость: изменяемость
тип: Типы Тип типов типах типа типе
данные: Данных данные
функция: Функции функцию Функция
комментарий: Комментарии
управлять: Управляющие
конструкция: конструкции Конструкция
понимание: Понимание
владение: владения владение
такой: такое Таким
ссылка: Ссылки ссылок ссылками
заимствование: заимствование
срез: среза Срез срезе
использование: Использование использовании использования использованием
структура: структур структуры структуре структурах
объединение: объединения
связать: связанных связанными
определение: Определение
создание: создание
экземпляр: экземпляров экземпляра
пример: Пример Примеры Примером
программа: программы
использовать: использующей использовать использующие используют
синтаксис: Синтаксис синтаксисом синтаксиса
метод: метода методы метод методов
перечисление: Перечисления перечислений перечислениях
сопоставление: сопоставление
образец: образцом
поток: потока поток потоков потоками
управление: управления Управление
лаконичный: Лаконичный
расти: растущими
проект: проектами Проект проекта
помощь: помощью
пакет: пакетов Пакеты
крейт: крейтов крейты крейта
модуль: модулей
область: областью область области
действие: действия
конфиденциальность: конфиденциальностью
путь: Пути путей путём
элемент: элемент элементов
дерево: дереве
видимость: видимости
ключевой: ключевого Ключевые
слово: слова
коллекция: коллекции
хранение: Хранение хранения
список: списков Список списки
значение: значений значениями значения значение значением
вектор: векторами вектор
закодировать: закодированного
текст: текста
строка: строками строки строках
ключ: ключей ключа
обработка: Обработка обработки
ошибка: ошибок ошибки ошибках
неустранимый: Неустранимые
устранимые: Устранимые
характеристика: характеристики
время: время
жизнь: жизни
обобщенные: Обобщённые
разделять: разделяемого
поведение: поведения поведение
валидация: Валидация
срок: сроков
написание: Написание
автоматический: автоматических
тест: тестов тесты
как: Как
писать: писать
выполнение: выполнением Выполнение выполнения
организация: Организация
ввод: вводом
вывод: выводом вывода
командный: командной
получение: Получение
аргумент: аргументов
чтение: Чтение
файл: файла файлов
рефакторинг: Рефакторинг
обеспечение: обеспечения
модульность: модульности
улучшение: улучшения Улучшение
разработка: Разработка разработки
функциональность: функциональности
библиотека: библиотеки библиотеке библиотекой
тестирование: тестирование
работа: Работа работы
среда: среды
запись: Запись
сообщение: сообщений
вместо: вместо
функциональный: Функциональные
возможность: возможности возможностей
итератор: итераторы итераторов
замыкание: замыкания
анонимный: анонимные
который: которые который которых которое котором которого
захватывать: захватывают
свой: своё свои
окружение: окружение
последовательность: последовательности
наш: нашего
сравнение: Сравнение сравнения
производительность: производительности
цикл: циклы
подробнее: Подробнее
настройка: Настройка
билд: билдов
профиль: профилей
выпуск: выпуска
публикация: Публикация
рабочий: Рабочие
бинарный: бинарных
расширение: Расширение
добавление: добавления
пользовательский: пользовательских
команда: команд
умный: Умные умными умный
указатель: указатели указателями указатель
указание: указания
куча: куче кучи
обычный: обычными
трейт: трейта трейтов трейт
код: кода код
очистка: очистке очистка
подсчет: подсчётом
внутренний: внутренняя
ссылочные: Ссылочные
мочь: могут может могли можете
привести: привести
утечка: утечке
память: памяти
безбоязненный: Безбоязненный
параллелизм: параллелизм
параллельный: параллельного
пересылка: Пересылка
передача: передачи
состояние: состоянием
расширять: Расширяемый
объектный: объектно
ориентировать: ориентированного ориентированных
объект: объектов объекты объект объекта объектами
допускать: допускающих
разный: разных
реализация: Реализация реализации реализацию
шаблон: шаблона Шаблоны шаблон
проектирование: проектирования
весь: Все всем всех
место: места местах
где: где
использоваться: использоваться используется
опровержимость: Опровержимость
соответствовать: соответствовать
расширить: Расширенные
небезопасный: Небезопасный
продвинуть: Продвинутые
типаж: типажи типажа типажом типаж типажей
макрос: Макросы макросов макроса макрос
финальный: Финальный
многопоточный: многопоточного многопоточный
веб: веб
сервер: сервера сервер
однопоточный: однопоточного
превращение: Превращение превращения
мягкий: Мягкое
завершение: завершение
приложение: Приложения
а: А
оператор: Операторы операторов операторами
символ: символы
полезный: Полезные
инструмент: инструменты
редакция: Редакции
перевод: Переводы
книга: книги
создаваться: создаётся
дополнение: Дополнение дополнении
многий: многих
часть: частях части
мы: мы
обсуждать: обсуждали
атрибут: атрибут атрибуте
вы: Вы Вам
применить: применить применён
объявление: объявлению
генерировать: генерирует
умолчание: умолчанию
указать: указали указать
в: В
это: этом Это
рассказать: расскажем
каждый: Каждая каждый каждое каждого каждой
секция: секция секции секцию
содержать: содержит
операция: Операции
добавляемые: добавляемые
представить: представлена
рассказывать: рассказывает
условие: Условия
разрешить: разрешено разрешены
запретить: запрещено
реализовывать: реализовывать реализовывает реализовывающих
ситуация: ситуаций
требовать: требуют требует требовать
наличие: наличие
понадобиться: понадобилось
отличный: отличное
обратиться: обратитесь
документация: документации
стандартный: стандартной стандартное Стандартная
узнать: узнать
вручную: вручную
реализовать: реализовать реализованы реализуемых реализует реализующих реализуют реализующий
перечислить: Перечисленные
здесь: здесь
являться: являются является
единственный: единственными
определенный: определёнными определённые определённой
быть: быть будет были будут есть
ваш: ваших Ваш
другой: Другие другим другой
иметь: имеют имеет
ощутимый: ощутимого
поэтому: поэтому
решать: решать
они: их они них
достижение: достижения
цель: целей целью
нельзя: нельзя
обрабатывать: обрабатывает
форматирование: форматирование
конечный: конечных конечному
пользователь: пользователей пользователю
всегда: всегда
должный: должны должен
сам: сами самому
рассмотреть: рассмотреть рассмотрены
хороший: лучший
способ: способ Способы
отображение: отображения
какой: Какие Какой
просмотр: просмотра
найти: найдут
подходящий: подходящими подходящим
формат: формат
самый: самым
компилятор: Компилятор
знать: знает знать
ответ: ответы
этот: эти Этот этими этих
вопрос: вопросы
он: он нем него
подобрать: подобрать
подходить: подходящее
исчерпывающий: исчерпывающим
собственный: собственных
составлять: составляя
включать: включает
себя: себя себе
процедурный: процедурных
раздел: разделе
глава: главы
отладочный: отладочного отладочное
форматировать: форматируемых
фигурный: фигурных
скобка: скобок
позволять: позволяет
напечатать: напечатать
отладка: отладки
программист: программисты программистам программистами
смочь: смогут
проверить: проверить
точка: точке
обязательный: обязателен
некоторый: некоторых
случай: случаях случае
например: Например
печатать: печатает
входной: входных
совпадать: совпадают
увидеть: увидеть
почему: почему
равный: равны равен равно
равенство: равенства
сравнить: сравнить
один: одного одно одним
эквивалентность: эквивалентность
когда: Когда
два: два двух
поле: поля поле полей
отлично: отлично
вариант: вариант вариантам варианты
необходимый: необходимо необходим
сравнивать: сравнивать сравнивает
сигнализировать: сигнализирует
аннотировать: аннотированного
число: числа чисел число числом
плавать: плавающей
запятая: запятой
говорить: говорит
друг: друг другу
сказать: сказать
тот: тем ту то
порядок: порядка порядок порядке
сортировка: сортировки
возвращать: возвращает
выстраивать: выстраивают
упорядочено: упорядочено
вызов: Вызов вызова
любой: любым любого
вернуть: вернёт
объявить: объявлены объявленные
ранее: ранее
меньше: меньше
поздний: позже
потребоваться: потребоваться
случайный: случайные
заданный: заданном
диапазон: диапазоне диапазона
определить: определён
выражение: выражением
существовать: существовать
валидный: валидный
потому: потому
также: также
сохранение: сохранение
хранить: хранит
информация: информацию информации
основа: основе
отсортировать: отсортированных
дублирование: дублирования
явно: явно
создать: создать
глубокий: глубокую
копия: копию
процесс: процесс
вызывать: вызывать вызывает
специальный: специальный
копировать: копировать копируя
более: Более
детально: детально
смотрите: смотрите
взаимодействие: взаимодействия
клонирование: клонирование
подразумевать: подразумевает
владеть: владеет владеть
данный: данными
содержаться: содержащимися
возвратить: возвращённый
образ: образом
храниться: хранящийся хранятся хранящегося
дублировать: дублировать
стек: стеке
произвольный: произвольный произвольного
требоваться: требуется
стековые: Стековые
копирование: Копирование
больший: большей
предотвращение: предотвращения
перегрузка: перегрузки
бы: бы
нарушить: нарушило
соглашение: соглашение
никакой: никакой
запускаться: запускается
предполагать: предполагать
происходить: происходить
быстро: быстро
вывести: вывести
тривиальный: тривиальную
выполнять: выполняет
задача: задачу
нужный: нужен нужно
очень: очень
редко: редко
реализовывающие: реализовывающие
небольшой: небольшую
оптимизация: оптимизацию
делать: делает делаете делать
краткий: кратким
можно: можно
медленный: медленнее
фиксировать: фиксированного
размер: размера
превратить: превратить
хеш: хеш
комбинировать: комбинирует
результат: результаты результат
эффективный: эффективного
создавать: создавать
вызвать: вызовет
часто: часто
комбинация: комбинации
обновление: обновления
настроить: настроить
несколько: несколько
остальной: остальных
установить: установить
