переменный: Переменные переменными переменных переменная переменной переменным переменную
изменяемость: изменяемость изменяемости
язык: Язык языка языков
программирование: программирования Программирование
предисловие: Предисловие
введение: Введение
что: чего Что
начать: начать
установка: Установка
привет: Привет
мир: Мир
игра: игры игре
загадка: загадки
общий: Общие общим
концепция: концепции
тип: Типы Тип типов типом
данные: Данных данные
функция: Функции
комментарий: Комментарии
управлять: Управляющие
конструкция: конструкции Конструкция
понимание: Понимание понимания
владение: владения владение
такой: такое такой Таким такие
ссылка: Ссылки ссылок ссылками
заимствование: заимствование
срез: среза
использование: Использование использованием использовании использования
структура: структур структуры
объединение: объединения
связать: связанных связанными связанное связаны
определение: Определение
создание: создание
экземпляр: экземпляров
пример: Пример примере примеру
программа: программы программу программах программа программе
использовать: использующей используя использовать используемых используем
синтаксис: Синтаксис
метод: метода
перечисление: Перечисления
сопоставление: сопоставление
образец: образцом
поток: потока поток потоков потоками
управление: управления Управление
лаконичный: Лаконичный
расти: растущими
проект: проектами Проект проекта
помощь: помощью помощи
пакет: пакетов Пакеты
крейт: крейтов крейты крейта
модуль: модулей
область: областью область области
действие: действия
конфиденциальность: конфиденциальностью
путь: Пути путей
элемент: элемент элементов
дерево: дереве
видимость: видимости
ключевой: ключевого Ключевые ключевое
слово: слова слово словами
коллекция: коллекции
хранение: Хранение
список: списков
значение: значений значениями значения значение значению значением
вектор: векторами
закодировать: закодированного закодированных
текст: текста текстом
строка: строками строки
ключ: ключей
обработка: Обработка обработки
ошибка: ошибок ошибки ошибках ошибке ошибками ошибку Ошибка
неустранимый: Неустранимые
устранимые: Устранимые
трейты: трейты
характеристика: характеристики
время: время времени
жизнь: жизни
обобщенные: Обобщённые
разделять: разделяемого
поведение: поведения
валидация: Валидация
срок: сроков
написание: Написание написания
автоматический: автоматических
тест: тестов тесты
как: Как
писать: писать
выполнение: выполнением Выполнение выполнения
организация: Организация
ввод: вводом ввод
вывод: выводом выводе
командный: командной
получение: Получение
аргумент: аргументов
чтение: Чтение
файл: файла файлов
рефакторинг: Рефакторинг
обеспечение: обеспечения
модульность: модульности
улучшение: улучшения Улучшение
разработка: Разработка разработки
функциональность: функциональности
библиотека: библиотеки
тестирование: тестирование
работа: Работа работы
среда: среды
запись: Запись
сообщение: сообщений сообщение
вместо: вместо
функциональный: Функциональные
возможность: возможности возможностей возможность
итератор: итераторы итераторов
замыкание: замыкания
анонимный: анонимные
который: которые который которой которых которое
захватывать: захватывают
свой: своё своего
окружение: окружение
последовательность: последовательности
наш: нашего наша
сравнение: Сравнение
производительность: производительности
цикл: циклы
подробнее: Подробнее
настройка: Настройка
билд: билдов
профиль: профилей
выпуск: выпуска
публикация: Публикация
рабочий: Рабочие
бинарный: бинарных
расширение: Расширение
добавление: добавления Добавление
пользовательский: пользовательских
команда: команд команды
умный: Умные умными умный
указатель: указатели указателями указатель
указание: указания
куча: куче
обычный: обычными
трейт: трейта трейтов трейт
код: кода код коде
очистка: очистке очистка
подсчет: подсчётом
внутренний: внутренняя внутренней внутреннее
ссылочные: Ссылочные
мочь: могут может можем
привести: привести приведённый
утечка: утечке
память: памяти
безбоязненный: Безбоязненный
параллелизм: параллелизм
параллельный: параллельного
пересылка: Пересылка
передача: передачи
состояние: состоянием
расширять: Расширяемый
объектный: объектно
ориентировать: ориентированного ориентированных
объект: объектов
допускать: допускающих
разный: разных разные
реализация: Реализация
шаблон: шаблона Шаблоны шаблон
проектирование: проектирования
весь: Все всех всего
место: места место
где: где
использоваться: использоваться используется
опровержимость: Опровержимость
соответствовать: соответствовать
расширить: Расширенные
небезопасный: Небезопасный
продвинуть: Продвинутые
типаж: типажи
макрос: Макросы
финальный: Финальный
многопоточный: многопоточного многопоточный
веб: веб
сервер: сервера сервер
однопоточный: однопоточного
превращение: Превращение превращений превращения
мягкий: Мягкое
завершение: завершение
приложение: Приложения
а: А
оператор: Операторы оператор
символ: символы
выводимые: Выводимые
полезный: Полезные полезной полезны полезными полезно
инструмент: инструменты
редакция: Редакции
перевод: Переводы
книга: книги
создаваться: создаётся
упоминаться: упоминалось
раздел: разделе Раздел
умолчание: умолчанию
неизменяемый: неизменяемы неизменяемой неизменяемым
это: Это этого этим этому
один: один одна одну
многий: многих
стимул: стимулов
позволять: позволяющий позволяет
преимущество: преимущества
безопасность: безопасности
удобный: удобной удобным
конкурентность: конкурентности
предоставлять: предоставляемых предоставляет
тот: Тем то том тех того
менее: менее
существовать: существует существуют существующей
сделать: сделать сделано
изменять: изменяемыми изменяет изменять
давать: Давайте
рассмотреть: рассмотрим
почему: почему
побуждать: побуждает
предпочесть: предпочесть
неизменяемость: неизменяемость неизменяемости
иногда: иногда
можно: можно
отказаться: отказаться
являться: является
привязка: привязки
имя: имени Имя именем имена
изменить: изменить изменим
он: его нем он
быть: будет быть было будут есть были будете
нельзя: нельзя
показать: показать показано
создать: создайте созданной
новый: новый новом новое новую
название: названием
каталог: каталоге
далее: Далее
открыть: откройте
заменить: замените
низкий: ниже
пока: пока
компилироваться: компилироваться
сохраните: Сохраните
запустить: запустите
получить: получено получили получим
этот: этом этой Эта эту эти
компилятор: компилятор компилятора
помогать: помогает
находить: находить
ваш: ваших ваш вашего
расстраивать: расстраивать
действительность: действительности
они: они их
означать: означают
делать: делает
правильно: правильно
вы: вы вами
ожидать: ожидаете
значить: значит
плохой: плохой
программист: программист
опытный: опытные
сталкиваться: сталкиваются
потому: потому
попытаться: попытались попытаемся
присвоить: присвоить
важный: Важно
попытка: попытке
объявить: объявленное объявить объявлены
выдаваться: выдавались
компиляция: компиляции
так: так
подобный: подобная
ситуация: ситуация ситуации
сбой: сбоям
часть: часть части частях частей
функционировать: функционирует
исходить: исходя
уверенность: уверенности
другой: другая другие Другой
большой: велика
вероятность: вероятность
первый: первая первых первую
выполнить: выполнит выполнить
предназначение: предназначения
причина: Причину
бывать: бывает
трудный: трудно
отследить: отследить
особенно: особенно
второй: вторая второй
изредка: изредка
гарантия: гарантию
оно: оно
действительно: действительно
измениться: изменится
нужный: нужно нужны
следить: следить
сам: самим сама самом
образ: образом
становиться: становится
проще: проще
однако: Однако
очень: очень
более: более
хотя: Хотя
добавить: добавив
глава: Главе
также: также
передавать: передаёт
будущий: будущим
читатель: читателям
намерение: намерение
обозначать: обозначая
например: Например
следующий: следующий следующем следующим следующее
запустив: Запустив
мы: мы Нам нас
результат: результат результатом
разрешить: разрешено
конечный: конечном
счет: счёте
решение: решение
оставаться: остаётся
зависеть: зависит
мнение: мнения
хороший: наилучшем
вариант: варианте
данный: данной данный
конкретный: конкретной
константа: Константы константами констант
изменяться: изменяться
несколько: несколько
различие: различий
всегда: всегда
объявление: объявления объявлении
должный: должен должны
указать: указан
аннотация: аннотации
беспокоиться: беспокойтесь
деталь: деталях
прямо: прямо
сейчас: сейчас
знать: знайте знать
аннотировать: аннотировать
объявлять: объявлять
любой: любой любое
включая: включая
глобальный: глобальную
последний: Последнее
отличие: отличие
задать: заданы
константный: константным
выражение: выражением
вычислить: вычисленного
ее: её
устанавливаться: устанавливается
умножение: умножения
количество: количество
секунда: секунд
минута: минуте минут
час: часе часов
посчитать: посчитать
соглашение: Соглашение
именование: именования
требовать: требует
заглавный: заглавных
буква: букв
подчеркивание: подчёркиванием
вычислять: вычислять
ограничить: ограниченный
набор: набор
операция: операций операции
записать: записать
понятный: понятным
простой: простым простое
проверка: проверки
способ: способом
дополнительный: Дополнительную
информация: информацию
какой: какие
см: см
справка: справки
вычисление: вычислениям
течение: течение
предел: пределах
свойство: свойство
домен: домене
максимальный: максимальное
очко: очков
заработать: заработать
игрок: игрок
скорость: скорость
свет: света
обозначение: Обозначение
жестко: жёстко
смысл: смысла
сопровождать: сопровождающим
иметь: иметь
единственный: единственное
будущее: будущем
потребоваться: потребуется
обновить: обновить
затенение: Затенение затенением
урок: уроке
угадайк: Угадайка
говорить: говорят говорит
затеняться: затеняется
увидеть: увидит
суть: сути
затенять: затеняет затенять
принимать: принимая
себя: себя
пора: пор
она: она
стать: станет стало
тень: тенью
закончиться: закончится
повторять: повторяя
сначала: сначала
привязывать: привязывает
затем: Затем
создавать: создаёт создаём
беря: беря
исходный: исходное
добавлять: добавляя
равный: равным
фигурный: фигурных
скобка: скобок
третий: третий
умножая: умножая
предыдущий: предыдущее
дать: дать
когда: Когда
заканчиваться: заканчивается
возвращаться: возвращается
вывести: выведет
отличаться: отличается
случайно: случайно
попробовать: попробуем
переназначить: переназначить
оставлять: оставляя
завершить: завершены
разница: разницей
совершенно: совершенно
снова: снова
еще: ещё
прежний: прежнее
спрашивать: спрашивает
пользователь: пользователя
сколько: сколько
пробел: пробелов пробела
хотеть: хочет хотим
разместить: разместить
некоторый: некоторым
запрашивать: запрашивая
дело: деле
сохранить: сохранить
число: число
строковый: строковым
числовой: числовым
избавлять: избавляет
необходимость: необходимости
придумывать: придумывать
повторно: повторно
разрешаться: разрешается
менять: менять
теперь: Теперь
изучить: изучили
работать: работают
различный: различные
